0eeeeeeeeeeeeeeeeeeeeeeeeeeeeeeeeeeee	e
0éééééééééééééééééééééééééééééééééééé	e
0jajajajajajajajajajajajajajajajajaja	ja
0neinneinneinneinneinneinneinneinnein	nein
abbonement	Abonnement
Abbrechung	Abbruch
Abbrechungen	Abrechnungen
abgehangten	abgehängten
abgeschaffen	abgeschafft
abschiednehmen	Abschied nehmen
Abundans	Abundanz
Abwechselungsreich	Abwechslungsreich
achsiche	achsige
Addresse	Adresse
afarung	Erfahrung
Aku	Akku
Aleine	Alleine
Allalei	Allerlei
allmöglichen	alle möglichen
Alterego	Alter Ego
Altesheimer	Alzheimer
Amaturenbrett	Armaturenbrett
änderen	ändern
angefangt	angefangen
angesehendste	angesehenste
Annalyse	Analyse
Annollierung	Annullierung
Ansichtnach	Ansicht nach
Antisemitistische	Antisemitische
antuhen	antauen
Anwesenzeiten	Anwesenheitszeiten
apetitt	Appetit
Aquisition	Akquisition
Arthriethis	Arthritis
artz	Arzt
Ärtzten	Ärzten
As	Ass
asoziieren	assoziieren
Assecoires	Accessoires
Assessoires	Accessoires
assozial	asozial
Athmosphäre	Atmosphäre
aufgesteht	aufgestanden
aufjedenfall	auf jeden Fall
Ausage	Aussage
ausergewöhnliche	außergewöhnliche
ausiehst	aussiehst
ausprache	Aussprache
authorisiert	autorisiert
Authorisierung	Autorisierung
Autonomität	Autonomie
Avantgardische	Avantgardeschi
awa	ach was
befehlte	befahl
befehlten	befehlen
Begierigkeit	Gierigkeit
beherschen	beherrschen
beinhält	beinhaltet
Bequemheit	Bequemlichkeit
Berreichs	Bereichs
berücksicht	berücksichtigt
berücksichtung	berücksichtigen
bescheidt	Bescheid
besigte	besiegte
Betriebsratzimmer	Betriebsradzimmer
bezuggenommen	Bezug genommen
Billiard	Billard
Billiardtisch	Billardtisch
bischen	bisschen
Bisquit	Biskuit
bißsichen	bisschen
Boing	Boeing
bombadiert	bombardiert
bordeaurot	bordeauxrot
Bortmesser	Bordmesser
Boxhorn	Bockshorn
bratete	briet
brateten	beratenen
bravüröse	bravuröse
Brilliant	Brillant
Changse	Chance
Chirugie	Chirurgie
chouch	Couch
Copyride	Copyright
dan	dann
Desinterese	Desinteresse
desweitere	des weitere
desweiteren	des Weiteren
detailiert	detailliert
deutsprachige	deutschsprachige
dier	dir
Dilletant	Dilettant
Diphterie	Diphtherie
Diphtong	Diphthong
dreite	dreiste
dreiundhalb	dreieinhalb
Durführung	Durchführung
Durschnittliche	Durchschnittliche
Durschnitts	Durchschnitts
Dutzen	Duzen
eckel	ecke
Ehrgeitz	Ehrgeiz
eigendlich	eigentlich
einandhalb	eineinhalb
Einfühlungsvolle	Einfühlungsvolke
Einfühlvermögen	Einfühlungsvermögen
eingetragt	eingetragen
einhaltest	einhältst
Einkaufstachen	Einkaufstaschen
einzigste	einzige
einzigstes	einziges
Einzustigen	Einzusteigen
eleminieren	eliminieren
E-Mals	E-Mails
emmens	immens
Energiesparung	Energieeinsparung
Entäuschung	Enttäuschung
enteuscht	enttäuscht
Entgeld	Entgelt
entgültig	endgültig
Erbung	Erbschaft
Erhöherung	Erhöhung
Erstsemesterin	Erstsemester
Erstsemesterinnen	Erstsemestern
ethymologisch	etymologisch
Exel	Excel
Extase	Ekstase
Fahrad	Fahrrad
familiaren	familiären
fangte	fing
fangten	fingen
Feedbäcks	Feedbacks
Felatio	Fellatio
Festells	Festfells
Fleißigkeit	Fleiß
Folklorische	Folkloristische
formalisation	Formalisierung
Freiwilligerin	Freiwilliger
Fritöse	Fritteuse
frug	fragte
Frühstuck	Frühstück
Frühstücksbuffét	Frühstücksbuffet
frühstüct	frühstückt
funkzoniere	funktioniere
für's	fürs
Fuschern	Fuschen
Gallerie	Galerie
Gallionsfigur	Galionsfigur
Gallop	Galopp
ganichts	gar nichts
gans	ganz
garnicht	gar nicht
Gebrauchsspuhren	Gebrauchsspuren
Gebrauspuren	Gebrauchsspuren
Gedächnis	Gedächtnis
Geerte	Geehrte
gefahl	befahl
gehäckelte	gehäkelte
geherrt	geharrt
Gehorsamkeitsverweigerung	Gehorsamsverweigerung
gehrter	geehrter
Geizigkeit	Geiz
geklabt	geklappt
gekukt	gekurt
gelessen	gelesen
geliegt	gelegt
genißen	genießen
Gerechtlichkeit	Genrechtlichkeit
Germanistikern	Germanistik
Gerüch	Geruch
gesäht	gesät
geschied	geschieht
Geschwindlichkeiten	Geschwindigkeiten
gesen	gesehen
Gesetztreue	Gesetzestreue
gesich	Gesicht
gestürmige	gestürmte
gestyled	gestylt
gesundlich	gesundheitlich
getrunkt	getrunken
geupdated	upgedatet
Gewohnheitsbedürftige	Gewöhnungsbedürftige
Gingko	Ginkgo
glass	Glas
Gleichrechtig	Gleichberechtigt
Glücklichkeit	Glücklichsein
Gottseidank	Gottseligkeit
Gradwanderung	Gratwanderung
Gries	Grieß
Gröhlerei	Grölerei
größeste	größte
Grundauf	Grundaug
Habilitant	Habilitand
Häherne	Häher
hälst	hältst
handzuhaben	handhaben
Hautreinheiten	Hautunreinheiten
Heilieds	Heileids
helfte	half
helften	halfen
herausfordung	herausfordern
Herstammung	Abstammung
Hilfstmittels	Hilfsmittels
Höchstwahrliche	Höchst wahrliche
Hofen	Hoffen
homeophatisch	homöopathisch
Hypothenuse	Hypotenuse
Inbälde	Inbilde
indifizierte	identifizierte
Installatör	Installateur
Interkurelle	Unterkurelle
Internetkafees	Internetkaffees
Interresentes	Interessantes
Intersannte	Interessante
Investion	Investition
jeztz	jetzt
Jugenschuhen	Jugendschuhen
Jurististische	Juristische
kaffeeteria	Cafeteria
kaffeeterien	Cafeterien
kaffe	Kaffee
kan	kann
Kanst	Kannst
känzeln	kanzeln
Kaput	Kaputt
karthesisch	kartesisch
Kilimandaro	Kilimandscharo
Kilimandjaro	Kilimandscharo
Kinderliche	Kinderleiche
Kittmesse	Kittmesser
Klemptner	Klempner
Kohleaustiegs	Kohleausstiegs
Kokusnuss	Kokosnuss
Kolateralschaden	Kollateralschaden
komen	kommen
Komilitone	Kommilitone
Komplexibilität	Komplexität
Konflikation	Konfliktion
könntes	könntest
Kontaktfreundliche	Kontakt-freundliche
Korrigierung	Korrigieren
krahn	Kran
Krankenhausen	Krankenhäuser
kreigt	kriegt
Kreissaal	Kreißsaal
läd	lädt
Legasteniker	Legastheniker
legendlich	lediglich
Leinensamen	Leinsamen
leiwagen	Leihwagen
Letztenendes	Letztendliches
Lexion	Lexikon
Leztem	Letztem
lizensieren	lizenzieren
Looser	Loser
lügte	log
lügten	logen
Lutos	Lotus
Lybien	Libyen
mägt	mögt
Makieren	Maskieren
maletriert	malträtiert
Managment	Management
Manhatten	Manhattan
Maschiene	Maschine
Matschscheiben	Mattscheiben
meißtens	meistens
menegment	Management
Migrationspackt	Migrationspakt
Millenium	Millennium
Millionmal	Million mal
Millitaristisch	Militaristisch
misserabel	miserabel
Missionariesierung	Missionierung
Misverständniss	Missverständnis
mitag	Mittag
Mitanader	Miteinander
Miteillung	Mitteilung
Mitenand	Miteinander
miter	mit er
Mitgliederinnen	Mitgliedersinnen
morgends	morgens
Motorad	Motorrad
motorisation	Motorisierung
must	musst
muter	Mutter
Nabend	'n Abend
nacher	nachher
nachste	nächste
nachvollzuziehen	nachvollziehen
Nachwievor	Nachwiegen
nähmlich	nämlich
Nahrichten	Nachrichten
Nahricht	Nachricht
Namenhaft	Namenshaft
näste	nächst
Neugierigkeit	Neugierig
nichtmal	nicht mal
nix	nichts
Nocheinmal	Noch einmal
Nützlighe	Nützliche
Nutzvolle	Nutzvolke
Obulus	Obolus
Organisative	Organisation
organisazion	Organisation
orginal	original
Östereich	Österreich
Overtüre	Ouvertüre
packet	Paket
Pappa	Papa
Paradontitis	Parodontitis
Paradontose	Parodontose
Parkours	Parcours
past	passt
patien	Partien
Pavillion	Pavillon
Peipsen	Piepsen
Phählen	Pfählen
Phillipinen	Philippinen
Phillippinen	Philippinen
Pinwand	Pinnwand
Portfolie	Portfolio
präventiert	verhindert
Preisnachlassung	Preisbachlassung
Probant	Proband
Probiren	Probeiren
Problemhaften	Problemhaft
proffessionale	professionelle
Projezierung	Projizierung
prwventieren	verhindern
Qualitätsbewußte	Qualitätsbewusste
Quarkkeulchen	Quarkkäulchen
Rabarber	Rhabarber
Rechtsschreibung	Rechtschreibung
Rechtsschreibungsfehler	Rechtssachreibungsfehler
Rechtssprechung	Rechtsprechung
Recourcen	Ressourcen
Reeling	Reling
Reperatur	Reparatur
Resusfaktor	Rhesusfaktor
Revisionierung	Revision
Rhytmus	Rhythmus
Rollade	Roulade
rückgenglich	rückgängig
Rückrat	Rückgrat
Rythmus	Rhythmus
Satelit	Satellit
Satzt	Satz
schafen	schaffen
Schertz	Scherz
schließten	schlossen
schließte	schloss
schmetterling	Schmetterling
Schullung	Schulung
Schwierichkeiten	Schwierigkeiten
Schwitch	Switch
Seperator	Separator
seperat	separat
Seriösität	Seriosität
Singel	Single
skuril	skurril
solltes	solltest
Sommerverien	Sommerverein
Sovjetunion	Sowjetunion
Spax-Schrauben	Spar-Schrauben
Speziellisierung	Spezialisierung
Staatsangehoerigkeit	Staatsangehörigkeit
Standart	Standard
Stehgreif	Stegreif
Stopschild	Stoppschild
Stop	Stopp
Strebergartens	Streberdgartens
sumarum	summarum
Sylvesternacht	Silvesternacht
symetrisch	symmetrisch
symphatisch	sympathisch
Taillie	Taille
Teammitgliederinnen	Teammitgliedern
Telephathie	Telepathie
tip	Tipp
tollerant	tolerant
totlangweilig	todlangweilig
totsicher	todsicher
trationelle	traditionelle
tuhen	ruhen
tuhe	tue
Tunier	Turnier
Txten	Texten
Übaweisung	Überweise
uberagende	überragende
überhaut	überhaupt
überrant	überrannt
übersäht	übersät
übertragten	überragten
übertragte	übertrage
uberträgt	überträgt
umandern	umwandern
Unabsichtige	Unbeabsichtigt
Unangenehmheiten	Unannehmlichkeiten
Unaufbesichtigte	Unbeaufsichtigte
Unausweichbare	Unausweichliche
unerkennlich	unkenntlich
unhervorgesehen	unvorhergesehen
Unproffesionnell	Unprofessionell
Unstimmlichkeit	Unsterblichkeit
unterbeligtnde	unterbelichtende
untergangen	unterfangen
unternehmenslüstige	unternehmensseitige
Unvorsehbare	Unvorhersehbare
Unwohlbefinden	Unwohlsein
Unzerbrechbare	Unterbrechbare
Urteilung	Verurteilung
valierende	validierende
Velour	Velours
veräht	verrät
verblüten	verblümten
verennt	verrennt
Verharkte	Verhakte
verheielte	verheilte
verhingen	verhängten
verhing	verhängte
Verließ	Verlies
Versantdienstleistern	Versanddienstleistern
Verschiden	Verschieden
versichen	versichern
verswinnen	verswingen
Verwahrlosigkeit	Verwahrlosung
Verwandschaft	Verwandtschaft
Verwante	Verwarnte
Verziehrte	Verzierte
viedeo	Video
viedersehen	wiedersehen
vieleicht	vielleicht
volkommen	vollkommen
voralem	vor allem
Voraussichtige	Voraussichtliche
vorraussetzlich	voraussichtlich
Vorraussetzung	Voraussetzung
vorraus	voraus
wagerecht	waagerecht
währe	wäre
wanderen	wandern
wan	wann
Warheit	Wahrheit
Warscheindlichkeit	Wahrscheinlichkeit
Waschten	Waschen
Waschtes	Waschset
ween	wen
weibt	weißt
Weinachten	Weihnachten
Weiterede	Weiterreden
wertgelegt	wert gelegt
widerum	wiederum
wiedaholung	Wiederholung
wiederlich	widerlich
wiederspiegeln	widerspiegeln
Wiedersprichst	Widersprichst
Wiederspruch	Widerspruch
Wienerschnitzels	Wiederschnitzels
wieviele	wie viele
Wigtiche	Wichtige
Wissbegierigkeit	Wissbegier
wohlfühln	wohlfühlen
Wolt	Wollt
wöruber	worüber
Würtenbergs	Württembergs
Zauberliche	Zauberleiche
zetel	Zettel
Zoolophie	Zoophilie
Zucchinis	Zucchini
Zuende	Zünde
zugesand	zugesandt
Zukünftsreiche	Zukunftsreiche
Zulaufror	Zulaufrohr
Zumbeispiel	Zugbeispiel
zurverfügung	zur Verfügung
zuverlässliche	zu verlässliche
Zuverlässlichkeit	Zuversichtlichkeit
