0eeeeeeeeeeeeeeeeeeeeeeeeeeeeeeeeeeee	e
0éééééééééééééééééééééééééééééééééééé	e
0nononononononononononononononononono	no
0yesyesyesyesyesyesyesyesyesyesyesyes	yes
abandonned	abandoned
abbout	about
aberation	aberration
abilityes	abilities
abilties	abilities
abilty	ability
abondon	abandon
abondoned	abandoned
abondoning	abandoning
abondons	abandons
aborigene	aborigine
abotu	about
abouta	about a
aboutit	about it
aboutthe	about the
abreviate	abbreviate
abreviated	abbreviated
abreviation	abbreviation
abritrary	arbitrary
absail	abseil
absailing	abseiling
abscence	absence
absense	absence
absolutly	absolutely
absorbsion	absorption
absorbtion	absorption
abudance	abundance
abundacies	abundances
abundancies	abundances
abundunt	abundant
abutts	abuts
acadamy	academy
acadmic	academic
accademic	academic
accademy	academy
acccused	accused
accelleration	acceleration
accension	ascension
acceptence	acceptance
acceptible	acceptable
accesories	accessories
accessable	accessible
accidant	accident
accidentaly	accidentally
accidently	accidentally
acclimitization	acclimatization
accomadate	accommodate
accomadated	accommodated
accomadates	accommodates
accomadating	accommodating
accomadation	accommodation
accomadations	accommodations
accomdate	accommodate
accomodate	accommodate
accomodated	accommodated
accomodates	accommodates
accomodating	accommodating
accomodation	accommodation
accomodations	accommodations
accompanyed	accompanied
accordeon	accordion
accordian	accordion
accoring	according
accoustic	acoustic
accquainted	acquainted
accrediation	accreditation
accredidation	accreditation
accross	across
accussed	accused
acedemic	academic
acheive	achieve
acheived	achieved
acheivement	achievement
acheivements	achievements
acheives	achieves
acheiving	achieving
acheivment	achievement
acheivments	achievements
achievment	achievement
achievments	achievements
achive	achieve
achived	achieved
achivement	achievement
achivements	achievements
acident	accident
acknowldeged	acknowledged
acknowledgeing	acknowledging
ackward	awkward
acommodate	accommodate
acomplish	accomplish
acomplished	accomplished
acomplishment	accomplishment
acomplishments	accomplishments
acording	according
acordingly	accordingly
acquaintence	acquaintance
acquaintences	acquaintances
acquiantence	acquaintance
acquiantences	acquaintances
acquited	acquitted
activites	activities
activly	actively
actualy	actually
acuracy	accuracy
acused	accused
acustom	accustom
acustommed	accustomed
adavanced	advanced
adbandon	abandon
addional	additional
addionally	additionally
additinally	additionally
additionaly	additionally
additonal	additional
additonally	additionally
addmission	admission
addopt	adopt
addopted	adopted
addoptive	adoptive
addresable	addressable
addres	address
addresed	addressed
addresing	addressing
addressess	addresses
addtion	addition
addtional	additional
adecuate	adequate
adequit	adequate
adhearing	adhering
adherance	adherence
admendment	amendment
admininistrative	administrative
adminstered	administered
adminstrate	administrate
adminstration	administration
adminstrative	administrative
adminstrator	administrator
admissability	admissibility
admissable	admissible
admited	admitted
admitedly	admittedly
adn	and
adolecent	adolescent
adquire	acquire
adquired	acquired
adquires	acquires
adquiring	acquiring
adresable	addressable
adres	address
adresing	addressing
adressable	addressable
adress	address
adressed	addressed
adressing	addressing
adventrous	adventurous
advertisment	advertisement
advertisments	advertisements
advesary	adversary
adviced	advised
aeriel	aerial
aeriels	aerials
afair	affair
afficianados	aficionados
afficionado	aficionado
afficionados	aficionados
affilate	affiliate
affilliate	affiliate
affort	effort
aforememtioned	aforementioned
againnst	against
agains	against
agaisnt	against
aganist	against
aggaravates	aggravates
aggreed	agreed
aggreement	agreement
aggregious	egregious
aggresive	aggressive
agian	again
agianst	against
agina	again
agin	again
aginst	against
agravate	aggravate
agre	agree
agred	agreed
agreeement	agreement
agreemnt	agreement
agregate	aggregate
agregates	aggregates
agreing	agreeing
agression	aggression
agressive	aggressive
agressively	aggressively
agressor	aggressor
agricultue	agriculture
agriculure	agriculture
agricuture	agriculture
agrieved	aggrieved
ahev	have
ahppen	happen
ahve	have
aicraft	aircraft
aiport	airport
airbourne	airborne
aircaft	aircraft
aircrafts	aircraft
aircrafts'	aircraft's
airporta	airports
airrcraft	aircraft
Aisian	Asian
albiet	albeit
alchohol	alcohol
alchoholic	alcoholic
alchol	alcohol
alcholic	alcoholic
alcohal	alcohol
alcoholical	alcoholic
aledge	allege
aledged	alleged
aledges	alleges
alege	allege
aleged	alleged
alegience	allegiance
algebraical	algebraic
algorhitms	algorithms
algoritm	algorithm
algoritms	algorithms
alientating	alienating
alledge	allege
alledged	alleged
alledgedly	allegedly
alledges	alleges
allegedely	allegedly
allegedy	allegedly
allegely	allegedly
allegence	allegiance
allegience	allegiance
allign	align
alligned	aligned
alliviate	alleviate
allready	already
allthough	although
alltime	all-time
alltogether	altogether
almsot	almost
alochol	alcohol
alomst	almost
alot	a lot
alotted	allotted
alowed	allowed
alowing	allowing
alreayd	already
alse	else
alsot	also
alternitives	alternatives
altho	although
althought	although
altough	although
alusion	allusion
alwasy	always
alwyas	always
amalgomated	amalgamated
amatuer	amateur
amature	amateur
amendmant	amendment
Amercia	America
amerliorate	ameliorate
amke	make
amking	making
ammend	amend
ammended	amended
ammendment	amendment
ammendments	amendments
ammount	amount
ammused	amused
amoung	among
amung	among
amunition	ammunition
analagous	analogous
analitic	analytic
analogeous	analogous
anarchim	anarchism
anarchistm	anarchism
anbd	and
ancestory	ancestry
ancilliary	ancillary
andd	and
androgenous	androgynous
androgeny	androgyny
anihilation	annihilation
aniversary	anniversary
annoint	anoint
annointed	anointed
annointing	anointing
annoints	anoints
annouced	announced
annualy	annually
annuled	annulled
anohter	another
anomolies	anomalies
anomolous	anomalous
anomoly	anomaly
anonimity	anonymity
anounced	announced
anouncement	announcement
ansalisation	nasalization
ansalization	nasalization
ansestors	ancestors
Antartic	Antarctic
anthropolgist	anthropologist
anthropolgy	anthropology
antiapartheid	anti-apartheid
anual	annual
anulled	annulled
anwsered	answered
anyhwere	anywhere
anyother	any other
anytying	anything
aparent	apparent
aparment	apartment
apenines	Apennines
aplication	application
aplied	applied
apolegetic	apologetic
apon	apron
apparant	apparent
apparantly	apparently
appart	apart
appartment	apartment
appartments	apartments
appealling	appealing
appeareance	appearance
appearence	appearance
appearences	appearances
appenines	Apennines
apperance	appearance
apperances	appearances
appereance	appearance
appereances	appearances
applicaiton	application
applicaitons	applications
appologies	apologies
appology	apology
apprearance	appearance
apprieciate	appreciate
approachs	approaches
appropiate	appropriate
appropraite	appropriate
appropropiate	appropriate
approproximate	approximate
approxamately	approximately
approxiately	approximately
approximitely	approximately
aprehensive	apprehensive
apropriate	appropriate
aproval	approval
aproximate	approximate
aproximately	approximately
aquaduct	aqueduct
aquaintance	acquaintance
aquainted	acquainted
aquiantance	acquaintance
aquire	acquire
aquired	acquired
aquiring	acquiring
aquisition	acquisition
aquitted	acquitted
aranged	arranged
arangement	arrangement
arbitarily	arbitrarily
arbitary	arbitrary
archaelogical	archaeological
archaelogists	archaeologists
archaelogy	archaeology
archaoelogy	archaeology
archaology	archaeology
archeaologist	archaeologist
archeaologists	archaeologists
archetect	architect
archetects	architects
archetectural	architectural
archetecturally	architecturally
archetecture	architecture
archiac	archaic
archictect	architect
architecht	architect
architechturally	architecturally
architechture	architecture
architechtures	architectures
architectual	architectural
archtype	archetype
archtypes	archetypes
aready	already
areodynamics	aerodynamics
argubly	arguably
arguement	argument
arguements	arguments
arised	arose
arival	arrival
armamant	armament
armistace	armistice
arogant	arrogant
arogent	arrogant
aroud	around
arrangment	arrangement
arrangments	arrangements
arrengement	arrangement
arrengements	arrangements
arround	around
artcile	article
artical	article
artice	article
articel	article
artifical	artificial
artifically	artificially
artillary	artillery
arund	around
asetic	ascetic
asfar	as far
asign	assign
aslo	also
asociated	associated
asorbed	absorbed
asphyxation	asphyxiation
assasin	assassin
assasinate	assassinate
assasinated	assassinated
assasinates	assassinates
assasination	assassination
assasinations	assassinations
assasined	assassinated
assasins	assassins
assassintation	assassination
assemple	assemble
assertation	assertion
asside	aside
assisnate	assassinate
assitant	assistant
assit	assist
assocation	association
assoicate	associate
assoicated	associated
assoicates	associates
assosication	assassination
asssassans	assassins
assualt	assault
assualted	assaulted
assymetrical	asymmetrical
assymetric	asymmetric
asteriod	asteroid
asthetic	aesthetic
asthetically	aesthetically
asume	assume
aswell	as well
atain	attain
atempting	attempting
atheistical	atheistic
athenean	Athenian
atheneans	Athenians
athiesm	atheism
athiest	atheist
atorney	attorney
atribute	attribute
atributed	attributed
atributes	attributes
attaindre	attainder
attemp	attempt
attemped	attempted
attemt	attempt
attemted	attempted
attemting	attempting
attemts	attempts
attendence	attendance
attendent	attendant
attendents	attendants
attened	attended
attension	attention
attitide	attitude
attributred	attributed
attrocities	atrocities
audeince	audience
auromated	automated
austrailia	Australia
austrailian	Australian
auther	author
authobiographic	autobiographic
authobiography	autobiography
authorative	authoritative
authorites	authorities
authorithy	authority
authoritiers	authorities
authoritive	authoritative
authrorities	authorities
automaticly	automatically
automibile	automobile
automonomous	autonomous
autor	author
autority	authority
auxilary	auxiliary
auxillaries	auxiliaries
auxillary	auxiliary
auxilliaries	auxiliaries
auxilliary	auxiliary
availabe	available
availablity	availability
availaible	available
availble	available
availiable	available
availible	available
avalable	available
avalance	avalanche
avaliable	available
avation	aviation
avengence	a vengeance
averageed	averaged
avilable	available
awared	awarded
awya	away
baceause	because
backgorund	background
backrounds	backgrounds
bakc	back
banannas	bananas
bandwith	bandwidth
bankrupcy	bankruptcy
banruptcy	bankruptcy
baout	about
basicaly	basically
basicly	basically
bcak	back
beachead	beachhead
beacuse	because
beastiality	bestiality
beatiful	beautiful
beaurocracy	bureaucracy
beaurocratic	bureaucratic
beautyfull	beautiful
becamae	became
becames	became
becasue	because
beccause	because
becomeing	becoming
becomming	becoming
becouse	because
becuase	because
bedore	before
beeing	being
befoer	before
beggin	begging
begginer	beginner
begginers	beginners
beggining	beginning
begginings	beginnings
beggins	begins
begining	beginning
beginnig	beginning
behavour	behavior
beleagured	beleaguered
beleif	belief
beleive	believe
beleived	believed
beleives	believes
beleiving	believing
Beligum	Belgium
belive	believe
belived	believed
belives	believes
belligerant	belligerent
bellweather	bellwether
bemusemnt	bemusement
beneficary	beneficiary
beng	being
benificial	beneficial
benifit	benefit
benifits	benefits
Bernouilli	Bernoulli
beseige	besiege
beseiged	besieged
beseiging	besieging
beteen	between
betwen	between
beween	between
bewteen	between
bigining	beginning
biginning	beginning
bilateraly	bilaterally
billingualism	bilingualism
binominal	binomial
bizzare	bizarre
blaim	blame
blaimed	blamed
blessure	blessing
Blitzkreig	Blitzkrieg
boaut	bout
bodydbuilder	bodybuilder
bombardement	bombardment
bombarment	bombardment
bondary	boundary
boook	book
borke	broke
boundry	boundary
bouyancy	buoyancy
bouyant	buoyant
boyant	buoyant
bradcast	broadcast
Brasillian	Brazilian
breakthough	breakthrough
breakthroughts	breakthroughs
breif	brief
breifly	briefly
brethen	brethren
bretheren	brethren
briliant	brilliant
brillant	brilliant
brimestone	brimstone
Britian	Britain
Brittish	British
broacasted	broadcast
broadacasting	broadcasting
broady	broadly
Buddah	Buddha
Buddist	Buddhist
buisness	business
buisnessman	businessman
buoancy	buoyancy
buring	burning
burried	buried
busines	business
busineses	businesses
busness	business
bussiness	business
caculater	calculator
cacuses	caucuses
cahracters	characters
calaber	caliber
calander	calendar
calculater	calculator
calculs	calculus
calenders	calendars
caligraphy	calligraphy
caluclate	calculate
caluclated	calculated
caluculate	calculate
caluculated	calculated
calulate	calculate
calulated	calculated
calulater	calculator
Cambrige	Cambridge
camoflage	camouflage
campagin	campaign
campain	campaign
campains	campaigns
candadate	candidate
candiate	candidate
candidiate	candidate
cannister	canister
cannisters	canisters
cannnot	cannot
cannonical	canonical
cannotation	connotation
cannotations	connotations
caost	coast
caperbility	capability
capible	capable
captial	capital
captued	captured
capturd	captured
carachter	character
caracterized	characterized
carcas	carcass
carefull	careful
careing	caring
carismatic	charismatic
Carnagie	Carnegie
Carnagie-Mellon	Carnegie-Mellon
carnege	carnage
carnige	carnage
Carnigie	Carnegie
Carnigie-Mellon	Carnegie-Mellon
carreer	career
carrers	careers
Carribbean	Caribbean
Carribean	Caribbean
carryng	carrying
cartdridge	cartridge
Carthagian	Carthaginian
carthographer	cartographer
cartilege	cartilage
cartilidge	cartilage
cartrige	cartridge
casette	cassette
casion	caisson
cassawory	cassowary
cassowarry	cassowary
casue	cause
casued	caused
casues	causes
casuing	causing
casulaties	casualties
casulaty	casualty
catagories	categories
catagorized	categorized
catagory	category
Cataline	Catalina
catapillar	caterpillar
catapillars	caterpillars
catapiller	caterpillar
catapillers	caterpillars
catepillar	caterpillar
catepillars	caterpillars
catergorize	categorize
catergorized	categorized
caterpilar	caterpillar
caterpilars	caterpillars
caterpiller	caterpillar
caterpillers	caterpillars
cathlic	catholic
Catholocism	Catholicism
catterpilar	caterpillar
catterpilars	caterpillars
catterpillar	caterpillar
catterpillars	caterpillars
cattleship	battleship
Ceasar	Caesar
Celcius	Celsius
cementary	cemetery
cemetarey	cemetery
cemetaries	cemeteries
cemetary	cemetery
cencus	census
censur	censure
cententenial	centennial
centruies	centuries
centruy	century
centuties	centuries
centuty	century
ceratin	certain
cerimonial	ceremonial
cerimonies	ceremonies
cerimonious	ceremonious
cerimony	ceremony
ceromony	ceremony
certainity	certainty
certian	certain
cervial	cervical
chalenging	challenging
challange	challenge
challanged	challenged
challege	challenge
Champange	Champagne
changable	changeable
charachter	character
charachters	characters
charactersistic	characteristic
charactor	character
charactors	characters
charasmatic	charismatic
charaterized	characterized
chariman	chairman
charistics	characteristics
chasr	chase
cheif	chief
cheifs	chiefs
chemcial	chemical
chemcially	chemically
chemestry	chemistry
chemicaly	chemically
childbird	childbirth
childen	children
choclate	chocolate
choosen	chosen
chracter	character
chuch	church
churchs	churches
Cincinatti	Cincinnati
Cincinnatti	Cincinnati
circulaton	circulation
circumsicion	circumcision
circut	circuit
ciricuit	circuit
ciriculum	curriculum
civillian	civilian
claer	clear
claerer	clearer
claerly	clearly
claimes	claims
clas	class
clasical	classical
clasically	classically
clasic	classic
cleareance	clearance
clera	clear
clincial	clinical
clinicaly	clinically
cmo	com
cmoputer	computer
coctail	cocktail
coform	conform
cognizent	cognizant
coincedentally	coincidentally
co-incided	coincided
colaborations	collaborations
colateral	collateral
colelctive	collective
collaberative	collaborative
collecton	collection
collegue	colleague
collegues	colleagues
collonade	colonnade
collonies	colonies
collony	colony
collosal	colossal
colonizators	colonizers
comander	commander
comando	commando
comandos	commandos
comany	company
comapany	company
comback	comeback
combanations	combinations
combinatins	combinations
combusion	combustion
comdemnation	condemnation
comemmorates	commemorates
comemoretion	commemoration
comision	commission
comisioned	commissioned
comisioner	commissioner
comisioning	commissioning
comisions	commissions
comission	commission
comissioned	commissioned
comissioner	commissioner
comissioning	commissioning
comissions	commissions
comited	committed
comiting	committing
comitted	committed
comittee	committee
comitting	committing
commandoes	commandos
commedic	comedic
commemerative	commemorative
commemmorate	commemorate
commemmorating	commemorating
commerical	commercial
commerically	commercially
commericial	commercial
commericially	commercially
commerorative	commemorative
comming	coming
comminication	communication
commision	commission
commisioned	commissioned
commisioner	commissioner
commisioning	commissioning
commisions	commissions
commited	committed
commitee	committee
commiting	committing
committe	committee
committment	commitment
committments	commitments
commmemorated	commemorated
commongly	commonly
commonweath	commonwealth
commuications	communications
commuinications	communications
communciation	communication
communiation	communication
communites	communities
compability	compatibility
comparision	comparison
comparisions	comparisons
comparitive	comparative
comparitively	comparatively
compatability	compatibility
compatable	compatible
compatablity	compatibility
compatiable	compatible
compatiblity	compatibility
compeitions	competitions
compensantion	compensation
competance	competence
competant	competent
competative	competitive
competion	completion
competitiion	competition
competive	competitive
competiveness	competitiveness
comphrehensive	comprehensive
compitent	competent
completedthe	completed the
completelyl	completely
completetion	completion
complier	compiler
componant	component
comprable	comparable
comprimise	compromise
compulsary	compulsory
compulsery	compulsory
computarized	computerized
concensus	consensus
concider	consider
concidered	considered
concidering	considering
conciders	considers
concieted	conceited
concieved	conceived
concious	conscious
conciously	consciously
conciousness	consciousness
condamned	condemned
condemmed	condemned
condidtion	condition
condidtions	conditions
conditionsof	conditions of
conected	connected
conection	connection
conesencus	consensus
confidental	confidential
confidentally	confidentially
confids	confides
configureable	configurable
confortable	comfortable
congradulations	congratulations
congresional	congressional
conived	connived
conjecutre	conjecture
conjuction	conjunction
Conneticut	Connecticut
conotations	connotations
conquerd	conquered
conquerer	conqueror
conquerers	conquerors
conqured	conquered
conscent	consent
consciouness	consciousness
consdider	consider
consdidered	considered
consdiered	considered
consectutive	consecutive
consenquently	consequently
consentrate	concentrate
consentrated	concentrated
consentrates	concentrates
consept	concept
consequentually	consequently
consequeseces	consequences
consern	concern
conserned	concerned
conserning	concerning
conservitive	conservative
consiciousness	consciousness
consicousness	consciousness
considerd	considered
consideres	considered
consious	conscious
consistant	consistent
consistantly	consistently
consituencies	constituencies
consituency	constituency
consituted	constituted
consitutional	constitutional
consitution	constitution
consolodate	consolidate
consolodated	consolidated
consonent	consonant
consonents	consonants
consorcium	consortium
conspiracys	conspiracies
conspiriator	conspirator
constaints	constraints
constanly	constantly
constarnation	consternation
constatn	constant
constinually	continually
constituant	constituent
constituants	constituents
constituional	constitutional
constituion	constitution
consttruction	construction
constuction	construction
consulant	consultant
consumate	consummate
consumated	consummated
contaiminate	contaminate
containes	contains
contamporaries	contemporaries
contamporary	contemporary
contempoary	contemporary
contemporaneus	contemporaneous
contempory	contemporary
contendor	contender
contian	contain
contians	contains
contibute	contribute
contibuted	contributed
contibutes	contributes
contigent	contingent
contined	continued
continential	continental
continous	continuous
continously	continuously
continueing	continuing
contravercial	controversial
contraversy	controversy
contributer	contributor
contributers	contributors
contritutions	contributions
controled	controlled
controling	controlling
controll	control
controlls	controls
controvercial	controversial
controvercy	controversy
controveries	controversies
controversal	controversial
controversey	controversy
controvertial	controversial
controvery	controversy
contruction	construction
contstruction	construction
conveinent	convenient
convenant	covenant
convential	conventional
convertables	convertibles
convertion	conversion
conviced	convinced
convienient	convenient
coordiantion	coordination
coorperation	cooperation
coorperations	corporations
copmetitors	competitors
coputer	computer
copywrite	copyright
coridal	cordial
cornmitted	committed
corosion	corrosion
corparate	corporate
corperations	corporations
correponding	corresponding
correposding	corresponding
correspondant	correspondent
correspondants	correspondents
corridoors	corridors
corrispondant	correspondent
corrispondants	correspondents
corrispond	correspond
corrisponded	corresponded
corrisponding	corresponding
corrisponds	corresponds
costitution	constitution
coucil	council
coudl	could
councellor	counselor
councellors	counselors
counries	countries
countains	contains
countires	countries
countrie's	countries'
coururier	courier
coverted	converted
cpoy	copy
creaeted	created
crèche	creche
creedence	credence
critereon	criterion
criterias	criteria
criticists	critics
critising	criticizing
critisising	criticizing
critisism	criticism
critisisms	criticisms
critisize	criticize
critisized	criticized
critisizes	criticizes
critisizing	criticizing
critized	criticized
critizing	criticizing
crockodiles	crocodiles
crowm	crown
crtical	critical
crticised	criticized
crucifiction	crucifixion
crusies	cruises
crutial	crucial
crystalisation	crystallization
culiminating	culminating
cumulatative	cumulative
curch	church
curcuit	circuit
currenly	currently
curriculem	curriculum
cxan	cyan
cyclinder	cylinder
dacquiri	daiquiri
daed	dead
dael	deal
Dalmation	Dalmatian
damenor	demeanor
dammage	damage
Dardenelles	Dardanelles
daugher	daughter
debateable	debatable
decendant	descendant
decendants	descendants
decendent	descendant
decendents	descendants
decideable	decidable
decidely	decidedly
decieved	deceived
decison	decision
decomissioned	decommissioned
decomposit	decompose
decomposited	decomposed
decompositing	decomposing
decomposits	decomposes
decress	decrees
decribed	described
decribe	describe
decribes	describes
decribing	describing
dectect	detect
defendent	defendant
defendents	defendants
deffensively	defensively
deffined	defined
deffine	define
definance	defiance
definate	definite
definately	definitely
definatly	definitely
definetly	definitely
definining	defining
definit	definite
definitly	definitely
definiton	definition
defintion	definition
degrate	degrade
delagates	delegates
delapidated	dilapidated
delerious	delirious
delevopment	development
deliberatly	deliberately
delusionally	delusively
demenor	demeanor
demographical	demographic
demolision	demolition
demorcracy	democracy
demostration	demonstration
denegrating	denigrating
densly	densely
deparmental	departmental
deparment	department
deparments	departments
dependance	dependence
dependancy	dependency
deram	dram
deriviated	derived
derivitive	derivative
derogitory	derogatory
descendands	descendants
descibed	described
descision	decision
descisions	decisions
descriibes	describes
descripters	descriptors
descripton	description
desctruction	destruction
descuss	discuss
desgined	designed
deside	decide
desigining	designing
desinations	destinations
desintegrated	disintegrated
desintegration	disintegration
desireable	desirable
desitned	destined
desktiop	desktop
desorder	disorder
desoriented	disoriented
desparate	desperate
despict	depict
despiration	desperation
dessicated	desiccated
dessigned	designed
destablized	destabilized
destory	destroy
detailled	detailed
detatched	detached
deteoriated	deteriorated
deteriate	deteriorate
deterioriating	deteriorating
determinining	determining
detremental	detrimental
devasted	devastated
develope	develop
developement	development
developped	developed
develpment	development
devels	delves
devestated	devastated
devestating	devastating
devided	divided
devide	divide
devistating	devastating
devolopement	development
diablical	diabolical
diamons	diamonds
diaster	disaster
dichtomy	dichotomy
diconnects	disconnects
dicover	discover
dicovered	discovered
dicovering	discovering
dicovers	discovers
dicovery	discovery
dictionarys	dictionaries
dicussed	discussed
didnt	didn't
diea	idea
dieing	dying
dieties	deities
diety	deity
diferent	different
diferrent	different
differnt	different
difficulity	difficulty
diffrent	different
dificulties	difficulties
dificulty	difficulty
dimenions	dimensions
dimentional	dimensional
dimention	dimension
dimentions	dimensions
dimesnional	dimensional
diminuitive	diminutive
dimunitive	diminutive
diosese	diocese
diphtong	diphthong
diphtongs	diphthongs
diplomancy	diplomacy
dipthong	diphthong
dipthongs	diphthongs
directoty	directory
dirived	derived
disagreeed	disagreed
disapeared	disappeared
disapointing	disappointing
disappearred	disappeared
disaproval	disapproval
disasterous	disastrous
disatisfaction	dissatisfaction
disatisfied	dissatisfied
disatrous	disastrous
discribed	described
discribe	describe
discribes	describes
discribing	describing
disctinction	distinction
disctinctive	distinctive
disemination	dissemination
disenchanged	disenchanted
disiplined	disciplined
disobediance	disobedience
disobediant	disobedient
disolved	dissolved
disover	discover
dispair	despair
disparingly	disparagingly
dispenced	dispensed
dispence	dispense
dispencing	dispensing
dispicable	despicable
dispite	despite
dispostion	disposition
disproportiate	disproportionate
disricts	districts
dissagreement	disagreement
dissapearance	disappearance
dissapear	disappear
dissapeared	disappeared
dissapearing	disappearing
dissapears	disappears
dissappear	disappear
dissappears	disappears
dissappointed	disappointed
dissarray	disarray
dissobediance	disobedience
dissobediant	disobedient
dissobedience	disobedience
dissobedient	disobedient
distiction	distinction
distingish	distinguish
distingished	distinguished
distingishes	distinguishes
distingishing	distinguishing
distingquished	distinguished
distrubution	distribution
distruction	destruction
distructive	destructive
ditributed	distributed
diversed	diverged
divice	device
divinition	divination
divison	division
divisons	divisions
doccument	document
doccumented	documented
doccuments	documents
docrines	doctrines
doctines	doctrines
documenatry	documentary
doens	does
doesnt	doesn't
doign	doing
dominaton	domination
dominent	dominant
dominiant	dominant
donig	doing
dosen't	doesn't
doub	doubt
doulbe	double
dowloads	downloads
dramtic	dramatic
Dravadian	Dravidian
dreasm	dreams
driectly	directly
drnik	drink
druming	drumming
dum	dumb
dupicate	duplicate
durig	during
durring	during
duting	during
dyas	drays
eahc	each
ealier	earlier
earlies	earliest
earnt	earned
ecclectic	eclectic
eceonomy	economy
ecidious	deciduous
eclispe	eclipse
ecomonic	economic
ect	etc
eearly	early
efel	evil
effeciency	efficiency
effecient	efficient
effeciently	efficiently
efficency	efficiency
efficent	efficient
efficently	efficiently
efford	afford
effords	affords
effulence	effluence
eigth	eight
eiter	either
elction	election
electic	electric
electon	electron
electrial	electrical
electricly	electrically
electricty	electricity
elementay	elementary
eleminated	eliminated
eleminating	eliminating
eles	eels
eletricity	electricity
elicided	elicited
eligable	eligible
elimentary	elementary
ellected	elected
elphant	elephant
embarassed	embarrassed
embarass	embarrass
embarassing	embarrassing
embarassment	embarrassment
embargos	embargoes
embarrased	embarrassed
embarras	embarrass
embarrasing	embarrassing
embarrasment	embarrassment
embezelled	embezzled
emblamatic	emblematic
eminated	emanated
eminate	emanate
emision	emission
emited	emitted
emiting	emitting
emition	emotion
emmediately	immediately
emmigrated	immigrated
emminent	imminent
emminently	eminently
emmisaries	emissaries
emmisarries	emissaries
emmisarry	emissary
emmisary	emissary
emmision	emission
emmisions	emissions
emmited	emitted
emmiting	emitting
emmitted	emitted
emmitting	emitting
emnity	enmity
emperical	empirical
emphaised	emphasized
emphsis	emphasis
emphysyma	emphysema
empirial	empirical
emporer	emperor
emprisoned	imprisoned
enameld	enameled
enchancement	enhancement
encouraing	encouraging
encryptiion	encryption
encylopedia	encyclopedia
endevors	endeavors
endevour	endeavor
endig	ending
enduce	induce
ened	need
enforceing	enforcing
engagment	engagement
engeneer	engineer
engeneering	engineering
engieneer	engineer
engieneers	engineers
enlargment	enlargement
enlargments	enlargements
Enlish	English
enourmous	enormous
enourmously	enormously
ensconsed	ensconced
entaglements	entanglements
enteratinment	entertainment
enthusiatic	enthusiastic
entitity	entity
entitlied	entitled
entrepeneur	entrepreneur
entrepeneurs	entrepreneurs
enviormental	environmental
enviormentally	environmentally
enviorment	environment
enviorments	environments
enviornmental	environmental
enviornmentalist	environmentalist
enviornmentally	environmentally
enviornment	environment
enviornments	environments
enviromental	environmental
enviromentalist	environmentalist
enviromentally	environmentally
enviroment	environment
enviroments	environments
envolutionary	evolutionary
envrionments	environments
enxt	next
epidsodes	episodes
epsiode	episode
equalibrium	equilibrium
equelibrium	equilibrium
equialent	equivalent
equilibium	equilibrium
equilibrum	equilibrium
equiped	equipped
equippment	equipment
equitorial	equatorial
equivelant	equivalent
equivelent	equivalent
equivilant	equivalent
equivilent	equivalent
equivlalent	equivalent
erally	really
eratically	erratically
eratic	erratic
eraticly	erratically
erested	arrested
errupted	erupted
esential	essential
esitmated	estimated
esle	else
especialy	especially
essencial	essential
essense	essence
essentail	essential
essentialy	essentially
essentual	essential
essesital	essential
estabishes	establishes
establising	establishing
ethnocentricm	ethnocentrism
ethose	ethos
Europian	European
Europians	Europeans
Eurpean	European
Eurpoean	European
evenhtually	eventually
eventally	eventually
eventhough	even though
eventially	eventually
eventualy	eventually
everthing	everything
everytime	every time
everyting	everything
eveyr	every
evidentally	evidently
exagerated	exaggerated
exagerate	exaggerate
exagerates	exaggerates
exagerating	exaggerating
exagerrated	exaggerated
exagerrate	exaggerate
exagerrates	exaggerates
exagerrating	exaggerating
examinated	examined
exampt	exempt
exapansion	expansion
excact	exact
excange	exchange
excecuted	executed
excecute	execute
excecutes	executes
excecuting	executing
excecution	execution
excedded	exceeded
excelent	excellent
excellance	excellence
excellant	excellent
excell	excel
excells	excels
excercise	exercise
exchanching	exchanging
excisted	existed
exculsivly	exclusively
execising	exercising
exection	execution
exectued	executed
exeedingly	exceedingly
exelent	excellent
exellent	excellent
exemple	example
exept	except
exeptional	exceptional
exerbated	exacerbated
exerbate	exacerbate
exerciese	exercises
exerpt	excerpt
exerpts	excerpts
exersize	exercise
exerternal	external
exhalted	exalted
exhibtion	exhibition
exibition	exhibition
exibitions	exhibitions
exicting	exciting
exinct	extinct
existance	existence
existant	existent
existince	existence
exliled	exiled
exludes	excludes
exmaple	example
exonorate	exonerate
exoskelaton	exoskeleton
expalin	explain
expatriot	expatriate
expeced	expected
expecially	especially
expeditonary	expeditionary
expeiments	experiments
expell	expel
expells	expels
experianced	experienced
experiance	experience
expiditions	expeditions
expierence	experience
explaination	explanation
explaning	explaining
explictly	explicitly
exploititive	exploitative
explotation	exploitation
expropiated	expropriated
expropiation	expropriation
exressed	expressed
extemely	extremely
extention	extension
extentions	extensions
extered	exerted
extermist	extremist
extint	extinct
extradiction	extradition
extraterrestial	extraterrestrial
extraterrestials	extraterrestrials
extravagent	extravagant
extrememly	extremely
extremly	extremely
extrordinarily	extraordinarily
extrordinary	extraordinary
eyars	years
eyar	year
eyasr	years
faciliated	facilitated
faciliate	facilitate
faciliates	facilitates
facilites	facilities
facillitate	facilitate
facinated	fascinated
facist	fascist
familes	families
familliar	familiar
famoust	famous
fanatism	fanaticism
Farenheit	Fahrenheit
fatc	fact
faught	fought
favoutrable	favorable
feasable	feasible
Febuary	February
Feburary	February
fedreally	federally
femminist	feminist
feromone	pheromone
fertily	fertility
fianite	finite
fianlly	finally
ficticious	fictitious
fictious	fictitious
fidn	find
fiel	file
fiels	files
fiercly	fiercely
fightings	fighting
filiament	filament
fimilies	families
finacial	financial
finaly	finally
financialy	financially
firends	friends
firts	flirts
fisionable	fissionable
flamable	flammable
flawess	flawless
fleed	fled
Flemmish	Flemish
flourescent	fluorescent
flourine	fluorine
flourishment	flourishing
fluorish	flourish
follwoing	following
folowing	following
fomed	formed
fomr	form
fonetic	phonetic
foootball	football
forbad	forbade
forbiden	forbidden
foreward	foreword
forfiet	forfeit
forhead	forehead
foriegn	foreign
Formalhaut	Fomalhaut
formallized	formalized
formallize	formalize
formaly	formally
formelly	formerly
formidible	formidable
formost	foremost
forsaw	foresaw
forseeable	foreseeable
fortelling	foretelling
forunner	forerunner
foucs	focus
foudn	found
fougth	fought
foundaries	foundries
foundary	foundry
Foundland	Newfoundland
fourties	forties
fourty	forty
fouth	fourth
foward	forward
Fransiscan	Franciscan
Fransiscans	Franciscans
freind	friend
freindly	friendly
frequentily	frequently
fromed	formed
frome	from
froniter	frontier
fucntion	function
fucntioning	functioning
fufilled	fulfilled
fufill	fulfill
fulfiled	fulfilled
fullfilled	fulfilled
fullfill	fulfill
fundametal	fundamental
fundametals	fundamentals
funguses	fungi
funtion	function
furuther	further
futher	further
futhermore	furthermore
gae	game
galatic	galactic
Galations	Galatians
gallaxies	galaxies
galvinized	galvanized
Gameboy	Game Boy
ganerate	generate
ganes	games
ganster	gangster
garanteed	guaranteed
garantee	guarantee
garantees	guarantees
garnison	garrison
gauranteed	guaranteed
gaurantee	guarantee
gaurantees	guarantees
gaurd	guard
gaurenteed	guaranteed
gaurentee	guarantee
gaurentees	guarantees
geneological	genealogical
geneologies	genealogies
geneology	genealogy
generaly	generally
generatting	generating
genialia	genitalia
geographicial	geographical
geometrician	geometer
gerat	great
Ghandi	Gandhi
glamourous	glamorous
glight	flight
gnawwed	gnawed
godesses	goddesses
godess	goddess
Godounov	Godunov
gogin	going
goign	going
gonig	going
gouvener	governor
govement	government
govenment	government
govenrment	government
goverance	governance
govermental	governmental
goverment	government
governer	governor
governmnet	government
govormental	governmental
govorment	government
govornment	government
gracefull	graceful
graet	great
grafitti	graffiti
gramatically	grammatically
grammaticaly	grammatically
grammer	grammar
grat	great
gratuitious	gratuitous
greatful	grateful
greatfully	gratefully
greif	grief
gridles	griddles
gropu	group
grwo	grow
Guaduloupe	Guadeloupe
Guadulupe	Guadalupe
guage	gauge
guarenteed	guaranteed
guarentee	guarantee
guarentees	guarantees
Guatamala	Guatemala
Guatamalan	Guatemalan
guerrila	guerrilla
guerrilas	guerrillas
guidence	guidance
Guiness	Guinness
Guiseppe	Giuseppe
gunanine	guanine
guranteed	guaranteed
gurantee	guarantee
gurantees	guarantees
guttaral	guttural
gutteral	guttural
haemorrage	hemorrhage
haev	have
halarious	hilarious
Hallowean	Halloween
halp	help
hapened	happened
hapen	happen
hapening	happening
happended	happened
happend	happened
happenned	happened
harased	harassed
harases	harasses
harasment	harassment
harassement	harassment
harrased	harassed
harrases	harasses
harras	harass
harrasing	harassing
harrasment	harassment
harrassed	harassed
harrasses	harassed
harrassing	harassing
harrassment	harassment
hasnt	hasn't
Hatian	Haitian
haviest	heaviest
headquarer	headquarter
headquatered	headquartered
headquater	headquarter
headquaters	headquarters
healthercare	healthcare
heared	heard
heathy	healthy
Heidelburg	Heidelberg
heigher	higher
heirarchy	hierarchy
heiroglyphics	hieroglyphics
helment	helmet
helpfull	helpful
helpped	helped
hemmorhage	hemorrhage
herad	heard
heridity	heredity
heroe	hero
heros	heroes
hertiage	heritage
hertzs	hertz
hesistant	hesitant
heterogenous	heterogeneous
hieght	height
hierachical	hierarchical
hierachies	hierarchies
hierachy	hierarchy
hierarcical	hierarchical
hierarcy	hierarchy
hieroglph	hieroglyph
hieroglphs	hieroglyphs
higer	higher
higest	highest
higway	highway
hillarious	hilarious
himselv	himself
hinderance	hindrance
hinderence	hindrance
hindrence	hindrance
hipopotamus	hippopotamus
hismelf	himself
historicians	historians
hitsingles	hit singles
holf	hold
holliday	holiday
homestate	home state
homogeneized	homogenized
homogeneize	homogenize
honory	honorary
horrifing	horrifying
hosited	hoisted
hospitible	hospitable
hounour	honor
housr	hours
howver	however
hsitorians	historians
hstory	history
hten	then
htere	there
htey	they
htikn	think
hting	thing
htink	think
htis	this
humer	humor
humerous	humorous
huminoid	humanoid
humurous	humorous
husban	husband
hvae	have
hvaing	having
hvea	have
hwihc	which
hwile	while
hwole	whole
hydogen	hydrogen
hydropilic	hydrophilic
hydropobic	hydrophobic
hygeine	hygiene
hyjack	hijack
hyjacking	hijacking
hypocracy	hypocrisy
hypocrasy	hypocrisy
hypocricy	hypocrisy
hypocrit	hypocrite
hypocrits	hypocrites
iconclastic	iconoclastic
idaeidae	idea
idaes	ideas
idealogies	ideologies
idealogy	ideology
identicial	identical
identifers	identifiers
ideosyncratic	idiosyncratic
idesa	ideas
idiosyncracy	idiosyncrasy
Ihaca	Ithaca
illegimacy	illegitimacy
illegitmate	illegitimate
illess	illness
illiegal	illegal
illution	illusion
ilness	illness
ilogical	illogical
imagenary	imaginary
imaginery	imaginary
imagin	imagine
imanent	imminent
imcomplete	incomplete
imediately	immediately
imense	immense
imigrant	immigrant
imigrated	immigrated
imigration	immigration
iminent	imminent
immediatley	immediately
immediatly	immediately
immidately	immediately
immidiately	immediately
immitated	imitated
immitate	imitate
immitating	imitating
immitator	imitator
impecabbly	impeccably
impedence	impedance
implamenting	implementing
implimented	implemented
impliment	implement
imploys	employs
importamt	important
impressario	impresario
imprioned	imprisoned
imprisonned	imprisoned
improvision	improvisation
improvments	improvements
inablility	inability
inaccessable	inaccessible
inadiquate	inadequate
inadquate	inadequate
inadvertant	inadvertent
inadvertantly	inadvertently
inagurated	inaugurated
inaguration	inauguration
inappropiate	inappropriate
inaugures	inaugurates
inbalanced	imbalanced
inbalance	imbalance
inbetween	between
incarcirated	incarcerated
incidentially	incidentally
incidently	incidentally
inclreased	increased
includ	include
includng	including
incompatabilities	incompatibilities
incompatability	incompatibility
incompatable	incompatible
incompatablities	incompatibilities
incompatablity	incompatibility
incompatiblities	incompatibilities
incompatiblity	incompatibility
incompetance	incompetence
incompetant	incompetent
incomptable	incompatible
incomptetent	incompetent
inconsistant	inconsistent
incoroporated	incorporated
incorperation	incorporation
incorportaed	incorporated
incorprates	incorporates
incorruptable	incorruptible
incramentally	incrementally
increadible	incredible
incredable	incredible
inctroduced	introduced
inctroduce	introduce
incuding	including
incunabla	incunabula
indefinately	indefinitely
indefineable	undefinable
indefinitly	indefinitely
indentical	identical
indepedantly	independently
indepedence	independence
independance	independence
independant	independent
independantly	independently
independece	independence
independendet	independent
indespensable	indispensable
indespensible	indispensable
indictement	indictment
indigineous	indigenous
indipendence	independence
indipendent	independent
indipendently	independently
indispensible	indispensable
indisputible	indisputable
indisputibly	indisputably
individualy	individually
indpendent	independent
indpendently	independently
indulgue	indulge
indutrial	industrial
indviduals	individuals
inefficienty	inefficiently
inevatible	inevitable
inevitible	inevitable
inevititably	inevitably
infalability	infallibility
infallable	infallible
infectuous	infectious
infered	inferred
infilitrated	infiltrated
infilitrate	infiltrate
infilitration	infiltration
infinit	infinite
inflamation	inflammation
influencial	influential
influented	influenced
infomation	information
informtion	information
infrantryman	infantryman
infrigement	infringement
ingenius	ingenious
ingreediants	ingredients
inhabitans	inhabitants
inherantly	inherently
inheritage	inheritance
inheritence	inheritance
inital	initial
initally	initially
initation	initiation
initiaitive	initiative
inlcuding	including
inmigrant	immigrant
inmigrants	immigrants
innoculated	inoculated
inocence	innocence
inofficial	unofficial
inot	into
inpeach	impeach
inpending	impending
inpenetrable	impenetrable
inpolite	impolite
inprisonment	imprisonment
inproving	improving
insectiverous	insectivorous
insensative	insensitive
inseperable	inseparable
insistance	insistence
insitution	institution
insitutions	institutions
inspite	in spite
instade	instead
instatance	instance
institue	institute
instuction	instruction
instuments	instruments
instutionalized	institutionalized
instutions	institutions
insurence	insurance
intelectual	intellectual
inteligence	intelligence
inteligent	intelligent
intenational	international
intented	intended
intepretation	interpretation
intepretator	interpreter
interational	international
interbread	interbred
interchangable	interchangeable
interchangably	interchangeably
intercontinential	intercontinental
intercontinetal	intercontinental
intered	interned
interelated	interrelated
interferance	interference
interfereing	interfering
intergrated	integrated
intergration	integration
interm	interim
internation	international
interpet	interpret
interrim	interim
interrugum	interregnum
intertaining	entertaining
interupt	interrupt
intervines	intervenes
intevene	intervene
intial	initial
intially	initially
intrduced	introduced
intrest	interest
introdued	introduced
intruduced	introduced
intrumental	instrumental
intrument	instrument
intruments	instruments
intrusted	entrusted
intutive	intuitive
intutively	intuitively
inudstry	industry
inumerable	innumerable
inventer	inventor
invertibrates	invertebrates
investingate	investigate
involvment	involvement
irelevent	irrelevant
iresistable	irresistible
iresistably	irresistibly
iresistible	irresistible
iresistibly	irresistibly
iritable	irritable
iritated	irritated
ironicly	ironically
irrelevent	irrelevant
irreplacable	irreplaceable
irresistable	irresistible
irresistably	irresistibly
isnt	isn't
Israelies	Israelis
issueing	issuing
itnroduced	introduced
iunior	junior
iwll	will
iwth	with
Janurary	January
Januray	January
Japanes	Japanese
Jaques	Jacques
jeapardy	jeopardy
jewllery	jewelry
jorunal	journal
Jospeh	Joseph
jouney	journey
journied	journeyed
journies	journeys
jstu	just
jsut	just
Juadaism	Judaism
Juadism	Judaism
judical	judicial
judisuary	judiciary
juducial	judicial
juristiction	jurisdiction
juristictions	jurisdictions
kindergarden	kindergarten
Klenex	Kleenex
knive	knife
knowlegeable	knowledgeable
knowlege	knowledge
knwo	know
knwos	knows
konw	know
konws	knows
kwno	know
labatory	laboratory
labled	labeled
labratory	laboratory
laguage	language
laguages	languages
larg	large
largst	largest
Larrry	Larry
lastr	last
lattitude	latitude
launchs	launches
launhed	launched
lavae	larvae
layed	laid
lazyness	laziness
leage	league
leanr	learn
leathal	lethal
lefted	left
legitamate	legitimate
legitmate	legitimate
Leibnitz	Leibniz
lenght	length
leran	learn
lerans	learns
leutenant	lieutenant
levetated	levitated
levetate	levitate
levetates	levitates
levetating	levitating
levle	level
liasion	liaison
liason	liaison
liasons	liaisons
libary	library
libell	libel
libguistic	linguistic
libguistics	linguistics
lible	liable
lieing	lying
liekd	liked
liek	like
liesure	leisure
lieuenant	lieutenant
lieved	lived
liftime	lifetime
lightyear	light year
lightyears	light years
likelyhood	likelihood
Lippizaner	Lipizzaner
liquify	liquefy
liscense	license
lisence	license
lisense	license
listners	listeners
litature	literature
literaly	literally
literture	literature
littel	little
litterally	literally
liuke	like
livley	lively
lmits	limits
loev	love
lonelyness	loneliness
longitudonal	longitudinal
lonley	lonely
lonly	lonely
lsat	last
lveo	love
lvoe	love
Lybia	Libya
maching	matching
mackeral	mackerel
magasine	magazine
magincian	magician
magisine	magazine
magizine	magazine
magnificient	magnificent
magolia	magnolia
mailny	mainly
maintainance	maintenance
maintainence	maintenance
maintance	maintenance
maintenence	maintenance
maintinaing	maintaining
maintioned	mentioned
majoroty	majority
maked	made
makse	makes
Malcom	Malcolm
maltesian	Maltese
mamalian	mammalian
mamal	mammal
managable	manageable
managment	management
maneouvred	maneuvered
maneouvre	maneuver
maneouvres	maneuvers
maneouvring	maneuvering
manisfestations	manifestations
manoeuverability	maneuverability
manouverability	maneuverability
manouverable	maneuverable
manouver	maneuver
manouvers	maneuvers
mantained	maintained
manuever	maneuver
manuevers	maneuvers
manufacturedd	manufactured
manufatured	manufactured
manufature	manufacture
manufaturing	manufacturing
manuver	maneuver
mariage	marriage
marjority	majority
markes	marks
marketting	marketing
marmelade	marmalade
marrage	marriage
marraige	marriage
marrtyred	martyred
marryied	married
Massachussets	Massachusetts
Massachussetts	Massachusetts
massmedia	mass media
masterbation	masturbation
mataphysical	metaphysical
materalists	materialist
mathamatics	mathematics
mathematican	mathematician
mathematicas	mathematics
matheticians	mathematicians
mathmatically	mathematically
mathmatician	mathematician
mathmaticians	mathematicians
mchanics	mechanics
meaninng	meaning
mear	mere
mechandise	merchandise
medacine	medicine
medeival	medieval
medevial	medieval
mediciney	medicine
medievel	medieval
Mediterainnean	Mediterranean
Mediteranean	Mediterranean
melieux	milieus
memeber	member
menally	mentally
meranda	Miranda
mercentile	mercantile
messanger	messenger
messenging	messaging
metalic	metallic
metalurgical	metallurgical
metalurgic	metallurgic
metalurgy	metallurgy
metamorphysis	metamorphosis
metaphoricial	metaphorical
meterologist	meteorologist
meterology	meteorology
methaphor	metaphor
methaphors	metaphors
Michagan	Michigan
micoscopy	microscopy
mileau	milieu
milennia	millennia
milennium	millennium
mileu	milieu
miliary	military
miligram	milligram
milion	million
miliraty	military
millenial	millennial
millenia	millennia
millenium	millennium
millepede	millipede
millioniare	millionaire
millitant	militant
millitary	military
millon	million
miltary	military
minature	miniature
minerial	mineral
ministery	ministry
minsitry	ministry
minstries	ministries
minstry	ministry
minumum	minimum
mirrorred	mirrored
miscelaneous	miscellaneous
miscellanious	miscellaneous
miscellanous	miscellaneous
mischeivous	mischievous
mischevious	mischievous
mischievious	mischievous
misdameanor	misdemeanor
misdameanors	misdemeanors
misdemenor	misdemeanor
misdemenors	misdemeanors
misfourtunes	misfortunes
misile	missile
Misouri	Missouri
mispelled	misspelled
mispelling	misspelling
mispell	misspell
missen	mizzen
Missisipi	Mississippi
Missisippi	Mississippi
missle	missile
missonary	missionary
misterious	mysterious
mistery	mystery
misteryous	mysterious
mkae	make
mkaes	makes
mkaing	making
mkea	make
moderm	modem
modle	model
moent	moment
moeny	money
moleclues	molecules
momento	memento
monestaries	monasteries
monestary	monastery
monickers	monikers
monolite	monolithic
Monserrat	Montserrat
montains	mountains
montanous	mountainous
Montnana	Montana
monts	months
moreso	more so
morgage	mortgage
Morroccan	Moroccan
Morrocco	Morocco
morroco	morocco
mortage	mortgage
mosture	moisture
motiviated	motivated
mounth	month
movei	movie
movment	movement
mroe	more
mucuous	mucous
mudering	murdering
muder	murder
muhammadan	Muhammadan
multicultralism	multiculturalism
multipled	multiplied
multiplers	multipliers
munbers	numbers
muncipalities	municipalities
muncipality	municipality
munnicipality	municipality
muscels	muscles
muscial	musical
muscician	musician
muscicians	musicians
mutiliated	mutilated
myraid	myriad
mysef	myself
mysogynist	misogynist
mysogyny	misogyny
mysterous	mysterious
naieve	naive
Naploeon	Napoleon
Napolean	Napoleon
Napoleonian	Napoleonic
naturaly	naturally
naturely	naturally
naturually	naturally
naturual	natural
Nazereth	Nazareth
neccesarily	necessarily
neccesary	necessary
neccessarily	necessarily
neccessary	necessary
neccessities	necessities
necesarily	necessarily
necesary	necessary
necessiate	necessitate
neglible	negligible
negligable	negligible
negociate	negotiate
negociation	negotiation
negociations	negotiations
negotation	negotiation
neice	niece
neigborhood	neighborhood
neigbourhood	neighborhood
neigbouring	neighboring
neigbour	neighbor
neigbours	neighbors
neolitic	neolithic
nessasarily	necessarily
nessecary	necessary
nestin	nesting
neverthless	nevertheless
newletters	newsletters
nightime	nighttime
nineth	ninth
ninteenth	nineteenth
ninty	ninety
nkow	know
nkwo	know
nmae	name
noncombatents	noncombatants
nonsence	nonsense
nontheless	nonetheless
noone	no one
norhern	northern
northen	northern
northereastern	northeastern
notabley	notably
noteable	notable
noteably	notably
noteriety	notoriety
nothern	northern
noth	north
noticable	noticeable
noticably	noticeably
noticeing	noticing
noticible	noticeable
notwhithstanding	notwithstanding
Novermber	November
nowdays	nowadays
nowe	now
nto	not
nucular	nuclear
nuculear	nuclear
nuisanse	nuisance
numberous	numerous
Nuremburg	Nuremberg
nusance	nuisance
nutritent	nutrient
nutritents	nutrients
nuturing	nurturing
obediance	obedience
obediant	obedient
obession	obsession
obssessed	obsessed
obstacal	obstacle
obstancles	obstacles
obstruced	obstructed
ocasionally	occasionally
ocasional	occasional
ocasionaly	occasionally
ocasioned	occasioned
ocasion	occasion
ocasions	occasions
ocassionally	occasionally
ocassional	occasional
ocassionaly	occasionally
ocassioned	occasioned
ocassion	occasion
ocassions	occasions
occaison	occasion
occassionally	occasionally
occassional	occasional
occassionaly	occasionally
occassioned	occasioned
occassion	occasion
occassions	occasions
occationally	occasionally
occour	occur
occurance	occurrence
occurances	occurrences
occured	occurred
occurence	occurrence
occurences	occurrences
occuring	occurring
occurrance	occurrence
occurrances	occurrences
occurr	occur
ocuntries	countries
ocuntry	country
ocurrance	occurrence
ocurred	occurred
ocurrence	occurrence
ocurr	occur
offcers	officers
offcially	officially
offereings	offerings
offically	officially
offical	official
officals	officials
officaly	officially
officialy	officially
offred	offered
oftenly	often
oging	going
olther	other
omision	omission
omited	omitted
omiting	omitting
omlette	omelet
ommision	omission
ommited	omitted
ommiting	omitting
ommitted	omitted
ommitting	omitting
omniverously	omnivorously
omniverous	omnivorous
omre	more
onot	not
onyl	only
openess	openness
oponent	opponent
oportunity	opportunity
opose	oppose
oposite	opposite
oposition	opposition
oppenly	openly
oppinion	opinion
opponant	opponent
oppononent	opponent
oppositition	opposition
oppossed	opposed
opprotunity	opportunity
opression	oppression
opressive	oppressive
opthalmic	ophthalmic
opthalmologist	ophthalmologist
opthalmology	ophthalmology
opthamologist	ophthalmologist
optmizations	optimizations
optomism	optimism
orded	ordered
organim	organism
organistion	organization
organiztion	organization
orginally	originally
orginal	original
orginize	organize
orgin	origin
oridinarily	ordinarily
origanaly	originally
originall	original
originaly	originally
originially	originally
originnally	originally
origional	original
orignally	originally
orignially	originally
otehr	other 
otherwordly	otherworldly
oublisher	publisher
ouevre	oeuvre
oustanding	outstanding
overshaddowed	overshadowed
overthere	over there
overwelming	overwhelming
overwheliming	overwhelming
owrk	work
owudl	would
oxigen	oxygen
oximoron	oxymoron
paide	paid
paitience	patience
palce	palace
Paleolitic	Paleolithic
paliamentarian	parliamentarian
Palistian	Palestinian
Palistinian	Palestinian
Palistinians	Palestinians
pallete	palette
pamflet	pamphlet
pamplet	pamphlet
pantomine	pantomime
paralell	parallel
paralel	parallel
paranthesis	parenthesis
paraphenalia	paraphernalia
parellels	parallels
parisitic	parasitic
parituclar	particular
parliment	parliament
parrakeets	parakeets
parralel	parallel
parrallell	parallel
parrallel	parallel
partialy	partially
particually	particularly
particualr	particular
particuarly	particularly
particularily	particularly
particulary	particularly
pary	party
pased	passed
pasengers	passengers
passerbys	passersby
pasttime	pastime
pastural	pastoral
paticular	particular
pattented	patented
pavillion	pavilion
pblisher	publisher
pbulisher	publisher
peacefuland	peaceful and
peageant	pageant
peaple	people
peaples	peoples
peculure	peculiar
pedestrain	pedestrian
peformed	performed
peice	piece
penatly	penalty
penisula	peninsula
penisular	peninsular
penninsula	peninsula
penninsular	peninsular
pennisula	peninsula
Pennyslvania	Pennsylvania
pensinula	peninsula
pensle	pencil
peom	poem
peoms	poems
peopel	people
peopels	peoples
peotry	poetry
perade	parade
percepted	perceived
percieved	perceived
percieve	perceive
perenially	perennially
peretrator	perpetrator
perfomance	performance
perfomers	performers
performence	performance
performes	performed
perhasp	perhaps
perheaps	perhaps
perhpas	perhaps
peripathetic	peripatetic
peristent	persistent
perjery	perjury
perjorative	pejorative
permanant	permanent
permenantly	permanently
permenant	permanent
permissable	permissible
perogative	prerogative
peronal	personal
perosnality	personality
perpertrated	perpetrated
perphas	perhaps
perpindicular	perpendicular
persan	person
perseverence	perseverance
persistance	persistence
persistant	persistent
personell	personnel
personel	personnel
personnell	personnel
persuded	persuaded
persued	pursued
persue	pursue
persuing	pursuing
persuit	pursuit
persuits	pursuits
pertubation	perturbation
pertubations	perturbations
pessiary	pessary
petetion	petition
Pharoah	Pharaoh
phenomenom	phenomenon
phenomenonal	phenomenal
phenomenonly	phenomenally
phenomonenon	phenomenon
phenomonon	phenomenon
phenonmena	phenomena
Philipines	Philippines
philisopher	philosopher
philisophical	philosophical
philisophy	philosophy
Phillipine	Philippine
Phillipines	Philippines
Phillippines	Philippines
phillosophically	philosophically
philospher	philosopher
philosphies	philosophies
philosphy	philosophy
Phonecian	Phoenician
phongraph	phonograph
phylosophical	philosophical
physicaly	physically
piblisher	publisher
pich	pitch
pilgrimmage	pilgrimage
pilgrimmages	pilgrimages
pinapple	pineapple
pinnaple	pineapple
pinoneered	pioneered
plagarism	plagiarism
planation	plantation
plantiff	plaintiff
plateu	plateau
plausable	plausible
playright	playwright
playwrite	playwright
playwrites	playwrights
pleasent	pleasant
plebicite	plebiscite
plesant	pleasant
poenis	penis
poeoples	peoples
poety	poetry
poisin	poison
polical	political
polinator	pollinator
polinators	pollinators
politican	politician
politicans	politicians
poltical	political
poluted	polluted
polute	pollute
polutes	pollutes
poluting	polluting
polution	pollution
polyphonyic	polyphonic
pomegranite	pomegranate
pomotion	promotion
poportional	proportional
popoulation	population
popularaty	popularity
populare	popular
populer	popular
porshan	portion
porshon	portion
portait	portrait
portayed	portrayed
portraing	portraying
Portugese	Portuguese
Portuguease	Portuguese
portugues	Portuguese
posessed	possessed
posesses	possesses
posessing	possessing
posession	possession
posessions	possessions
posess	possess
posion	poison
positon	position
possable	possible
possably	possibly
posseses	possesses
possesing	possessing
possesion	possession
possessess	possesses
possibile	possible
possibilty	possibility
possiblility	possibility
possiblilty	possibility
possiblities	possibilities
possiblity	possibility
possition	position
Postdam	Potsdam
posthomous	posthumous
postion	position
postive	positive
potatos	potatoes
potrait	portrait
potrayed	portrayed
poulations	populations
poverful	powerful
poweful	powerful
powerfull	powerful
ppublisher	publisher
practially	practically
practial	practical
practicaly	practically
practicioner	practitioner
practicioners	practitioners
practicly	practically
practioner	practitioner
practioners	practitioners
prairy	prairie
prarie	prairie
praries	prairies
pratice	practice
preample	preamble
precedessor	predecessor
preceeded	preceded
preceeding	preceding
preceed	precede
preceeds	precedes
precentage	percentage
precice	precise
precisly	precisely
precurser	precursor
predecesors	predecessors
predicatble	predictable
predicitons	predictions
predomiantly	predominately
prefered	preferred
prefering	preferring
preferrably	preferably
pregancies	pregnancies
preiod	period
preliferation	proliferation
premeired	premiered
premeire	premiere
preminence	preeminence
premission	permission
preocupation	preoccupation
prepair	prepare
prepartion	preparation
prepatory	preparatory
preperation	preparation
preperations	preparations
preriod	period
presedential	presidential
presense	presence
presidenital	presidential
presidental	presidential
presitgious	prestigious
prespective	perspective
prestigeous	prestigious
prestigous	prestigious
presumabely	presumably
presumibly	presumably
pretection	protection
prevelant	prevalent
preverse	perverse
previvous	previous
pricipal	principal
priciple	principle
priestood	priesthood
primarly	primarily
primatively	primitively
primative	primitive
primatives	primitives
primordal	primordial
principaly	principality
principial	principal
principlaity	principality
principly	principally
prinicipal	principal
privalege	privilege
privaleges	privileges
priveledges	privileges
priveleged	privileged
privelege	privilege
priveleges	privileges
priveliged	privileged
privelige	privilege
priveliges	privileges
privelleges	privileges
privilage	privilege
priviledge	privilege
priviledges	privileges
privledge	privilege
privte	private
probabilaty	probability
probablistic	probabilistic
probablly	probably
probalibity	probability
probaly	probably
probelm	problem
proccessing	processing
proccess	process
proceded	proceeded
procede	proceed
procedes	proceeds
procedger	procedure
proceding	proceeding
procedings	proceedings
proceedure	procedure
proces	process
processer	processor
proclaimation	proclamation
proclamed	proclaimed
proclaming	proclaiming
proclomation	proclamation
profesion	profusion
profesor	professor
professer	professor
proffesed	professed
proffesional	professional
proffesion	profession
proffesor	professor
profilic	prolific
progessed	progressed
progidy	prodigy
programable	programmable
progrom	program
progroms	programs
prohabition	prohibition
prominance	prominence
prominantly	prominently
prominant	prominent
prominately	predominately
promiscous	promiscuous
promotted	promoted
pronomial	pronominal
pronouced	pronounced
pronounched	pronounced
pronounciation	pronunciation
prooved	proved
proove	prove
prophacy	prophecy
propietary	proprietary
propmted	prompted
propoganda	propaganda
propogate	propagate
propogates	propagates
propogation	propagation
propostion	proposition
propotions	proportions
propperly	properly
propper	proper
proprietory	proprietary
proseletyzing	proselytizing
protaganist	protagonist
protaganists	protagonists
protocal	protocol
protoganist	protagonist
protrayed	portrayed
protruberance	protuberance
protruberances	protuberances
prouncements	pronouncements
provacative	provocative
provded	provided
provicial	provincial
provinicial	provincial
provisiosn	provision
provisonal	provisional
proximty	proximity
pseudononymous	pseudonymous
pseudonyn	pseudonym
psuedo	pseudo
psycology	psychology
psyhic	psychic
pubilsher	publisher
pubisher	publisher
publiaher	publisher
publically	publicly
publicaly	publicly
publicher	publisher
publihser	publisher
publisehr	publisher
publiser	publisher
publisger	publisher
publisheed	published
publisherr	publisher
publishher	publisher
publishor	publisher
publishre	publisher
publissher	publisher
publlisher	publisher
publsiher	publisher
publusher	publisher
puchasing	purchasing
Pucini	Puccini
pulisher	publisher
pumkin	pumpkin
puplisher	publisher
puritannical	puritanical
purposedly	purposely
purpotedly	purportedly
pursuaded	persuaded
pursuade	persuade
pursuades	persuades
pususading	persuading
puting	putting
pwoer	power
pyscic	psychic
qtuie	quite
quantaty	quantity
quantitiy	quantity
quarantaine	quarantine
Queenland	Queensland
questonable	questionable
quicklyu	quickly
quinessential	quintessential
quitted	quit
quizes	quizzes
qutie	quite
rabinnical	rabbinical
racaus	raucous
radiactive	radioactive
radify	ratify
raelly	really
rarified	rarefied
reaccurring	recurring
reacing	reaching
reacll	recall
readmition	readmission
realitvely	relatively
realsitic	realistic
realtions	relations
realyl	really
realy	really
reasearch	research
rebiulding	rebuilding
rebllions	rebellions
rebounce	rebound
reccomendations	recommendations
reccomended	recommended
reccomending	recommending
reccomend	recommend
reccommended	recommended
reccommending	recommending
reccommend	recommend
reccuring	recurring
receeded	receded
receeding	receding
receivedfrom	received from
recepient	recipient
recepients	recipients
receving	receiving
rechargable	rechargeable
reched	reached
recided	resided
recident	resident
recidents	residents
recide	reside
reciding	residing
reciepents	recipients
reciept	receipt
recieved	received
recieve	receive
reciever	receiver
recievers	receivers
recieves	receives
recieving	receiving
recipiant	recipient
recipiants	recipients
recived	received
recivership	receivership
recogise	recognize
recogize	recognize
recomended	recommended
recomending	recommending
recomend	recommend
recomends	recommends
recommedations	recommendations
recompence	recompense
reconaissance	reconnaissance
reconcilation	reconciliation
reconized	recognized
reconnaisance	reconnaissance
reconnaissence	reconnaissance
recontructed	reconstructed
recordproducer	record producer
recquired	required
recrational	recreational
recrod	record
recuiting	recruiting
recuring	recurring
recurrance	recurrence
rediculous	ridiculous
reedeming	redeeming
reenforced	reinforced
refect	reflect
refedendum	referendum
referal	referral
referece	reference
refereces	references
refered	referred
referemce	reference
referemces	references
referencs	references
refereneced	referenced
referenece	reference
refereneces	references
referiang	referring
refering	referring
refernce	reference
refernces	references
referrence	reference
referrences	references
referrs	refers
reffered	referred
refference	reference
reffering	referring
refrence	reference
refrences	references
refrers	refers
refridgeration	refrigeration
refridgerator	refrigerator
refromist	reformist
refusla	refusal
regardes	regards
regluar	regular
reguarly	regularly
regulaion	regulation
regulaotrs	regulators
regularily	regularly
rehersal	rehearsal
reicarnation	reincarnation
reigining	reigning
reknowned	renowned
reknown	renown
relaly	really
rela	real
relatiopnship	relationship
relativly	relatively
relected	reelected
releived	relieved
releive	relieve
releiver	reliever
releses	releases
relevence	relevance
relevent	relevant
reliablity	reliability
relient	reliant
religeous	religious
religously	religiously
religous	religious
relinqushment	relinquishment
relitavely	relatively
relized	realized
relpacement	replacement
remaing	remaining
remeber	remember
rememberable	memorable
rememberance	remembrance
remembrence	remembrance
remenant	remnant
remenicent	reminiscent
reminent	remnant
reminescent	reminiscent
reminscent	reminiscent
reminsicent	reminiscent
rendevous	rendezvous
rendezous	rendezvous
renedered	rendered
renewl	renewal
rennovated	renovated
rennovate	renovate
rennovating	renovating
rennovation	renovation
rentors	renters
reoccurrence	recurrence
reorganision	reorganization
repatition	repetition
repblican	republican
repblicans	republicans
repblic	republic
repblics	republics
repectively	respectively
repeition	repetition
repentence	repentance
repentent	repentant
repeteadly	repeatedly
repetion	repetition
repid	rapid
reponse	response
reponsible	responsible
reportadly	reportedly
represantative	representative
representive	representative
representives	representatives
reproducable	reproducible
reprtoire	repertoire
repsectively	respectively
reptition	repetition
repubican	republican
repubicans	republicans
repubic	republic
repubics	republics
republian	republican
republians	republicans
republi	republic
republis	republics
repulican	republican
repulicans	republicans
repulic	republic
repulics	republics
requirment	requirement
requred	required
resaurant	restaurant
resembelance	resemblance
resembes	resembles
resemblence	resemblance
resevoir	reservoir
residental	residential
resistable	resistible
resistence	resistance
resistent	resistant
respectivly	respectively
responce	response
responibilities	responsibilities
responisble	responsible
responnsibilty	responsibility
responsability	responsibility
responsibile	responsible
responsibilites	responsibilities
responsiblities	responsibilities
responsiblity	responsibility
ressemblance	resemblance
ressembled	resembled
ressemblence	resemblance
ressemble	resemble
ressembling	resembling
resssurecting	resurrecting
ressurected	resurrected
ressurection	resurrection
ressurect	resurrect
ressurrection	resurrection
restarant	restaurant
restarants	restaurants
restaraunteur	restaurateur
restaraunteurs	restaurateurs
restaraunt	restaurant
restaraunts	restaurants
restauranteurs	restaurateurs
restauration	restoration
restauraunt	restaurant
resteraunt	restaurant
resteraunts	restaurants
resticted	restricted
restraunt	restaurant
resturant	restaurant
resturants	restaurants
resturaunt	restaurant
resturaunts	restaurants
resurecting	resurrecting
retalitated	retaliated
retalitation	retaliation
retreive	retrieve
returnd	returned
revaluated	reevaluated
reveiw	review
reveral	reversal
reversable	reversible
revolutionar	revolutionary
rewitten	rewritten
rewriet	rewrite
rference	reference
rferences	references
rhymme	rhyme
rhythem	rhythm
rhythim	rhythm
rhytmic	rhythmic
rigeur	rigor
rigourous	rigorous
rininging	ringing
rised	raised
Rockerfeller	Rockefeller
rococco	rococo
rocord	record
roomate	roommate
rougly	roughly
rucuperate	recuperate
rudimentatry	rudimentary
rulle	rule
runing	running
runnung	running
russina	Russian
Russion	Russian
rwite	write
rythem	rhythm
rythim	rhythm
rythmic	rhythmic
rythm	rhythm
rythyms	rhythms
sacrafice	sacrifice
sacreligious	sacrilegious
Sacremento	Sacramento
sacrifical	sacrificial
saftey	safety
safty	safety
salery	salary
sanctionning	sanctioning
sandwhich	sandwich
Sanhedrim	Sanhedrin
santioned	sanctioned
sargant	sergeant
sargeant	sergeant
sasy	says
satelite	satellite
satelites	satellites
Saterday	Saturday
Saterdays	Saturdays
satisfactority	satisfactorily
satrically	satirically
satrical	satirical
satric	satiric
sattelite	satellite
sattelites	satellites
saught	sought
saveing	saving
saxaphone	saxophone
scandanavia	Scandinavia
scaricity	scarcity
scavanged	scavenged
schedual	schedule
scholarhip	scholarship
scholarstic	scholastic
scientfic	scientific
scientifc	scientific
scientis	scientist
scince	science
scinece	science
scirpt	script
scoll	scroll
screenwrighter	screenwriter
scrutinity	scrutiny
scuptures	sculptures
seached	searched
seaches	searches
seach	search
secceeded	succeeded
seceeded	succeeded
seceed	succeed
secratary	secretary
secretery	secretary
sedereal	sidereal
seeked	sought
segementation	segmentation
seguoys	segues
seige	siege
seing	seeing
seinor	senior
seldomly	seldom
senarios	scenarios
sence	sense
senstive	sensitive
sensure	censure
seperated	separated
seperately	separately
seperate	separate
seperates	separates
seperating	separating
seperation	separation
seperatism	separatism
seperatist	separatist
sepina	subpoena
sepulchure	sepulcher
sepulcre	sepulcher
sergent	sergeant
settelement	settlement
settlment	settlement
severeal	several
severley	severely
severly	severely
sevice	service
shaddow	shadow
shamen	shaman
sheat	sheet
sheild	shield
sherif	sheriff
shineing	shining
shiped	shipped
shiping	shipping
shopkeeepers	shopkeepers
shorly	shortly
shortwhile	short while
shoudln	shouldn't
shoudl	should
shouldnt	should not
shreak	shriek
shrinked	shrunk
sicne	since
sideral	sidereal
siezed	seized
sieze	seize
siezing	seizing
siezure	seizure
siezures	seizures
siginificant	significant
signficant	significant
signficiant	significant
signfies	signifies
signifantly	significantly
significently	significantly
signifigantly	significantly
signifigant	significant
signitories	signatories
signitory	signatory
similarily	similarly
similiarity	similarity
similiarly	similarly
similiar	similar
simmilar	similar
simpley	simply
simplier	simpler
simultanously	simultaneously
simultanous	simultaneous
sincerley	sincerely
singsog	singsong
sinse	since
Sionists	Zionists
Sionist	Zionist
Sixtin	Sistine
skateing	skating
slaugterhouses	slaughterhouses
slighly	slightly
slowy	slowly
smae	same
smealting	smelting
smoe	some
sneeks	sneaks
snese	sneeze
socalism	socialism
socities	societies
soem	some
sofware	software
sohw	show
soilders	soldiers
solatary	solitary
soley	solely
soliders	soldiers
soliliquy	soliloquy
soluable	soluble
somene	someone
somtimes	sometimes
somwhere	somewhere
sophicated	sophisticated
sophmore	sophomore
sorceror	sorcerer
sorrounding	surrounding
sotry	story
sotyr	story
soudn	sound
soudns	sounds
sould	should
sountrack	soundtrack
sourthern	southern
sourth	south
souvenier	souvenir
souveniers	souvenirs
soveits	soviets
sovereignity	sovereignty
soverignity	sovereignty
soverign	sovereign
soverignty	sovereignty
spainish	Spanish
speach	speech
specfic	specific
speciallized	specialized
specifiying	specifying
speciman	specimen
spectauclar	spectacular
spectaulars	spectaculars
spects	aspects
spectum	spectrum
speices	species
spendour	splendor
spermatozoan	spermatozoon
spoace	space
sponsered	sponsored
sponser	sponsor
spontanous	spontaneous
sponzored	sponsored
spoonfulls	spoonfuls
sppeches	speeches
spreaded	spread
sprech	speech
spred	spread
spriritual	spiritual
spritual	spiritual
sqaure	square
stablility	stability
stainlees	stainless
staion	station
standars	standards
stange	strange
startegic	strategic
startegies	strategies
startegy	strategy
stateman	statesman
statememts	statements
statment	statement
steriods	steroids
sterotypes	stereotypes
stilus	stylus
stingent	stringent
stiring	stirring
stirrs	stirs
stlye	style
stomache	stomach
stong	strong
stopry	story
storeis	stories
storise	stories
stornegst	strongest
stoyr	story
stpo	stop
stradegies	strategies
stradegy	strategy
stratagically	strategically
strat	start
streemlining	streamlining
stregth	strength
strenghened	strengthened
strenghening	strengthening
strenghen	strengthen
strenghtened	strengthened
strenghtening	strengthening
strenghten	strengthen
strenght	strength
strengtened	strengthened
strenous	strenuous
strictist	strictest
strikely	strikingly
strnad	strand
stroy	story
structual	structural
stubborness	stubbornness
stuctured	structured
stucture	structure
studdy	study
studing	studying
stuggling	struggling
sturcture	structure
subcatagories	subcategories
subcatagory	subcategory
subconsiously	subconsciously
subdivisio	subdivision
subjudgation	subjugation
subpecies	subspecies
subsidary	subsidiary
subsiduary	subsidiary
subsquently	subsequently
subsquent	subsequent
substace	substance
substancial	substantial
substatial	substantial
substituded	substituted
substracted	subtracted
substracting	subtracting
substraction	subtraction
substracts	subtracts
substract	subtract
subtances	substances
subterranian	subterranean
suburburban	suburban
succceeded	succeeded
succcesses	successes
succedded	succeeded
succeded	succeeded
succeds	succeeds
succesfully	successfully
succesful	successful
succesfuly	successfully
succesion	succession
succesive	successive
successfull	successful
successully	successfully
succsessfull	successful
succsess	success
suceeded	succeeded
suceeding	succeeding
suceeds	succeeds
suceed	succeed
sucesfully	successfully
sucesful	successful
sucesfuly	successfully
sucesion	succession
sucesses	successes
sucessfull	successful
sucessfully	successfully
sucessful	successful
sucessfuly	successfully
sucession	succession
sucessive	successive
sucessor	successor
sucessot	successor
sucess	success
sucide	suicide
sucidial	suicidal
sudents	students
sudent	student
sufferage	suffrage
sufferred	suffered
sufferring	suffering
sufficently	sufficiently
sufficent	sufficient
sumary	summary
sunglases	sunglasses
suop	soup
superceeded	superseded
superintendant	superintendent
suphisticated	sophisticated
suplimented	supplemented
suposedly	supposedly
suposed	supposed
suposes	supposes
supose	suppose
suposing	supposing
supplamented	supplemented
suppliementing	supplementing
suppoed	supposed
supposingly	supposedly
suppy	supply
suprassing	surpassing
supressed	suppressed
supresses	suppresses
supressing	suppressing
supress	suppress
suprised	surprised
suprise	surprise
suprisingly	surprisingly
suprising	surprising
suprized	surprised
suprize	surprise
suprizingly	surprisingly
suprizing	surprising
surfce	surface
surley	surely
surounded	surrounded
suroundings	surroundings
surounding	surrounding
surounds	surrounds
suround	surround
surplanted	supplanted
surpressed	suppressed
surpress	suppress
surprized	surprised
surprize	surprise
surprizingly	surprisingly
surprizing	surprising
surrended	surrendered
surrepetitiously	surreptitiously
surrepetitious	surreptitious
surreptiously	surreptitiously
surreptious	surreptitious
surronded	surrounded
surrouded	surrounded
surrouding	surrounding
surrundering	surrendering
surveilence	surveillance
surveyer	surveyor
survivers	survivors
surviver	survivor
survivied	survived
suseptable	susceptible
suseptible	susceptible
suspention	suspension
swaers	swears
swaer	swear
swepth	swept
swiming	swimming
syas	says
symetrically	symmetrically
symetrical	symmetrical
symetry	symmetry
symettric	symmetric
symmetral	symmetric
symmetricaly	symmetrically
synagouge	synagogue
syncronization	synchronization
synonomous	synonymous
synonymns	synonyms
synphony	symphony
syphyllis	syphilis
sypmtoms	symptoms
syrap	syrup
sysmatically	systematically
sytem	system
sytle	style
tabacco	tobacco
tahn	than
taht	that
talekd	talked
targetted	targeted
targetting	targeting
tast	taste
tath	that
tatoo	tattoo
tattooes	tattoos
taxanomic	taxonomic
taxanomy	taxonomy
teached	taught
techicians	technicians
techician	technician
techiniques	techniques
technitian	technician
technnology	technology
technolgy	technology
teh	the
tehy	they
telelevision	television
televsion	television
telphony	telephony
temerature	temperature
tempaltes	templates
tempalte	template
temparate	temperate
temperarily	temporarily
temperment	temperament
tempertaure	temperature
temperture	temperature
temprary	temporary
tenacles	tentacles
tenacle	tentacle
tendacy	tendency
tendancies	tendencies
tendancy	tendency
tennisplayer	tennis player
tepmorarily	temporarily
terrestial	terrestrial
terriories	territories
terriory	territory
territorist	terrorist
territoy	territory
terroist	terrorist
testiclular	testicular
testomony	testimony
tghe	the
thast	that's
theather	theater
theese	these
theif	thief
theives	thieves
themselfs	themselves
themslves	themselves
therafter	thereafter
therby	thereby
theri	their
ther	their
theyre	they're
thgat	that
thge	the
thier	their
thigns	things
thign	thing
thigsn	things
thikning	thickening
thikns	thinks
thikn	think
thiunk	think
thna	than
thne	then
thnigs	things
thnig	thing
thn	then
thoughout	throughout
threatend	threatened
threatning	threatening
threee	three
threshhold	threshold
thrid	third
throrough	thorough
throughly	thoroughly
throught	thought
througout	throughout
thsi	this
thsoe	those
thta	that
thyat	that
tiem	time
tihkn	think
tihs	this
timeschedule	time schedule
timne	time
tiome	time
tje	the
tjhe	the
tkaes	takes
tkae	take
tkaing	taking
tlaking	talking
tobbaco	tobacco
todays	today's
todya	today
toghether	together
tolerence	tolerance
Tolkein	Tolkien
tomatos	tomatoes
tommorow	tomorrow
tommorrow	tomorrow
tongiht	tonight
tormenters	tormentors
tornadoe	tornado
torpeados	torpedoes
torpedos	torpedoes
tortise	tortoise
tothe	to the
toubles	troubles
tounge	tongue
tourch	torch
towords	towards
towrad	toward
tradionally	traditionally
traditionaly	traditionally
traditionnal	traditional
traditition	tradition
tradtionally	traditionally
trafficed	trafficked
trafficing	trafficking
trafic	traffic
trancendent	transcendent
trancending	transcending
tranformed	transformed
tranform	transform
transcendance	transcendence
transcendant	transcendent
transcendentational	transcendental
transcripting	transcribing
transending	transcending
transesxuals	transsexuals
transfered	transferred
transfering	transferring
transformaton	transformation
transistion	transition
translaters	translators
translater	translator
transmissable	transmissible
transporation	transportation
tremelos	tremolos
tremelo	tremolo
trigered	triggered
triguered	triggered
triology	trilogy
troling	trolling
troups	troupes
troup	troupe
truely	truly
trustworthyness	trustworthiness
turnk	trunk
tust	trust
tution	tuition
twelth	twelfth
twon	town
twpo	two
tyhat	that
tyhe	they
typcial	typical
typicaly	typically
tyranies	tyrannies
tyrany	tyranny
tyrranies	tyrannies
tyrrany	tyranny
ubiquitious	ubiquitous
ublisher	publisher
uise	use
Ukranian	Ukrainian
ultimely	ultimately
unacompanied	unaccompanied
unahppy	unhappy
unanymous	unanimous
unathorised	unauthorized
unavailible	unavailable
unballance	unbalance
unbeknowst	unbeknownst
unbeleivable	unbelievable
uncertainity	uncertainty
unchangable	unchangeable
unconciousness	unconsciousness
unconcious	unconscious
unconfortability	discomfort
uncontitutional	unconstitutional
unconvential	unconventional
undecideable	undecidable
understoon	understood
undesireable	undesirable
undetecable	undetectable
undoubtely	undoubtedly
undreground	underground
uneccesary	unnecessary
unecessary	unnecessary
unequalities	inequalities
unforetunately	unfortunately
unforgetable	unforgettable
unforgiveable	unforgivable
unforseen	unforeseen
unfortunatley	unfortunately
unfortunatly	unfortunately
unfourtunately	unfortunately
unihabited	uninhabited
unilateraly	unilaterally
unilatreally	unilaterally
unilatreal	unilateral
uninterruped	uninterrupted
uninterupted	uninterrupted
univeral	universal
univeristies	universities
univeristy	university
univerity	university
universtiy	university
univesities	universities
univesity	university
unkown	unknown
unlikey	unlikely
unmistakeably	unmistakably
unneccesarily	unnecessarily
unneccesary	unnecessary
unneccessarily	unnecessarily
unneccessary	unnecessary
unnecesarily	unnecessarily
unnecesary	unnecessary
unoffical	unofficial
unoperational	nonoperational
unoticeable	unnoticeable
unplease	displease
unplesant	unpleasant
unprecendented	unprecedented
unprecidented	unprecedented
unrepentent	unrepentant
unrepetant	unrepentant
unrepetent	unrepentant
unsed	unused
unsubstanciated	unsubstantiated
unsuccesfully	unsuccessfully
unsuccesful	unsuccessful
unsuccessfull	unsuccessful
unsucesful	unsuccessful
unsucesfuly	unsuccessfully
unsucessfull	unsuccessful
unsucessfully	unsuccessfully
unsucessful	unsuccessful
unsuprisingly	unsurprisingly
unsuprising	unsurprising
unsuprizingly	unsurprisingly
unsuprizing	unsurprising
unsurprizingly	unsurprisingly
unsurprizing	unsurprising
untill	until
untranslateable	untranslatable
unuseable	unusable
unusuable	unusable
unviersity	university
unwarrented	unwarranted
unweildly	unwieldy
unwieldly	unwieldy
upcomming	upcoming
upgradded	upgraded
upto	up to
usally	usually
useage	usage
usefull	useful
usefuly	usefully
useing	using
usualy	usually
ususally	usually
vaccume	vacuum
vaccum	vacuum
vacinity	vicinity
vaguaries	vagaries
vaieties	varieties
vailidty	validity
Valetta	Valletta
valuble	valuable
valueable	valuable
varations	variations
varient	variant
variey	variety
varing	varying
varities	varieties
varity	variety
vasalls	vassals
vasall	vassal
vegatarian	vegetarian
vegitables	vegetables
vegitable	vegetable
vegtable	vegetable
vehicule	vehicle
vell	well
venemous	venomous
vengance	vengeance
vengence	vengeance
verfication	verification
verisons	versions
verison	version
vermillion	vermilion
versitilaty	versatility
versitlity	versatility
vetween	between
veyr	very
vigeur	vigor
vigilence	vigilance
vigourous	vigorous
villian	villain
villification	vilification
villify	vilify
villin	villain
vincinity	vicinity
violentce	violence
virtualy	virtually
virutally	virtually
virutal	virtual
visable	visible
visably	visibly
visting	visiting
vistors	visitors
vitories	victories
volcanoe	volcano
voleyball	volleyball
volontary	voluntary
volonteered	volunteered
volonteering	volunteering
volonteers	volunteers
volonteer	volunteer
volounteered	volunteered
volounteering	volunteering
volounteers	volunteers
volounteer	volunteer
volumne	volume
vreity	variety
vrey	very
vriety	variety
vulnerablility	vulnerability
vyer	very
vyre	very
waht	what
warantee	warranty
wardobe	wardrobe
warrent	warrant
warrriors	warriors
wasnt	wasn't
wass	was
watn	want
wayword	wayward
weaponary	weaponry
weas	was
wehn	when
weilded	wielded
weild	wield
wendsay	Wednesday
wensday	Wednesday
wereabouts	whereabouts
whants	wants
whant	want
whcih	which
wheras	whereas
wherease	whereas
whereever	wherever
whic	which
whihc	which
whith	with
whlch	which
whn	when
wholey	wholly
wholy	wholly
whta	what
whther	whether
wich	which
widesread	widespread
wief	wife
wierd	weird
wiew	view
wiht	with
wih	with
wille	will
willingless	willingness
willk	will
wirting	writing
withdrawl	withdrawal
witheld	withheld
withh	with
withold	withhold
witht	with
witn	with
wiull	will
wnated	wanted
wnats	wants
wnat	want
wohle	whole
wokring	working
wokr	work
wonderfull	wonderful
wordlwide	worldwide
workststion	workstation
worls	world
worstened	worsened
woudl	would
wresters	wrestlers
wriet	write
writen	written
wroet	wrote
wroking	working
wrok	work
wtih	with
wupport	support
xenophoby	xenophobia
yaching	yachting
yaerly	yearly
yaers	years
yaer	year
yatch	yacht
yearm	year
yeasr	years
yeilding	yielding
yeild	yield
Yementite	Yemenite
yeras	years
yera	year
yersa	years
yotube	YouTube
youself	yourself
yrea	year
ytou	you
yuo	you
zeebra	zebra
