0eeeeeeeeeeeeeeeeeeeeeeeeeeeeeeeeeeee	e
0éééééééééééééééééééééééééééééééééééé	e
0nonnonnonnonnonnonnonnonnonnonnonnon	non
0ouiouiouiouiouiouiouiouiouiouiouioui	oui
abatement	abattement
abbrév	abrév
abbréviation	abréviation
abræus	abraeus
acceuil	accueil
accordaille	accordailles
acollé	accolé
acoller	accoler
addresse	adresse
adept	adepte
aechmée	æchmée
aegagropile	ægagropile
aegilops	ægilops
aegipius	ægipius
aegoceros	ægoceros
aegopode	ægopode
aegosome	ægosome
aegyrine	ægyrine
aegyrinique	ægyrinique
aegyrite	ægyrite
aepyornis	æpyornis
aerarium	ærarium
æsar	aesar
aeschne	æschne
aeschynanthe	æschynanthe
aeschynomène	æschynomène
aesculus	æsculus
aesthésiom	æsthésiom
aetheling	ætheling
aethrioscop	æthrioscop
aethuse	æthuse
aggrégation	agrégation
aggress	agress
aggression	agression
agrè	agrès
aigue	aigüe
alstroemère	alstrœmère
alstroemérie	alstrœmérie
althaea	althæa
amabassadeur	ambassadeur
ambigue	ambigüe
ambiguité	ambigüité
ammener	amener
angstroem	angstrœm
apartement	appartement
apartenir	appartenir
apeler	appeler
apparement	apparemment
appella	appela
appellé	appelé
appercevoir	apercevoir
appliquation	application
aprés	après
aps	pas
ardement	ardemment
arrhe	arrhes
atol	atoll
atribué	attribué
atribuée	attribuée
atribuer	attribuer
attrappe	attrape
baggage	bagage
bails	baux
balaeniceps	balæniceps
binome	binôme
binômia	binomia
bleux	bleus
bloquage	blocage
boeuvon	bœuvon
Bolkenstein	Bolkestein
bruyament	bruyamment
caecaux	cæcaux
caecilia	cæcilia
caecum	cæcum
caelostat	cælostat
caenogénèse	cænogénèse
caenoménèse	cænoménèse
caesium	cæsium
caillous	cailloux
caloenas	calœnas
carapaçon	caparaçon
carapaçons	caparaçons
carnavaux	carnavals
cauchemard	cauchemar
cérémoniaux	cérémonials
chacaux	chacals
chappelle	chapelle
chevals	chevaux
choeur	chœur
cobaea	cobæa
coeur	cœur
commme	comme
commtié	commité
companie	compagnie
complaisament	complaisamment
connection	connexion
constament	constamment
contrepéterie	contrepèterie
contrepétrie	contrepèterie
corails	coraux
coralien	corallien
corolliare	corollaire
correspondence	correspondance
courament	couramment
courrir	courir
dance	danse
débacle	débâcle
deça	deçà
decade	décade
deception	déception
default	défaut
defiance	défiance
dévellop(|p)e	développe
dévelope	développe
dilemne	dilemme
diligement	diligemment
discution	discussion
disfonction	dysfonction
distortion	distorsion
dnas	dans
doléancse	doléances
ecologu	écologu
égaement	également
eglise	église
electronique	électronique
élégament	élégamment
elevation	élévation
émails	émaux
émeux	émeus
emission	émission
entraille	entrailles
envelope	enveloppe
épousaille	épousailles
equateur	équateur
éthymologi	étymologi
Éthymologi	Étymologi
ets	est
evidant	évidant
evident	évident
evince	évince
example	exemple
festivaux	festivals
fiançaille	fiançailles
fœhn	foehn
foeticide	fœticide
foetus	fœtus
fréquement	fréquemment
funérailes	funérailles
galament	galamment
gallerie	galerie
générals	généraux
genous	genoux
giraffe	girafe
glaeosporium	glæosporium
grandparents	grands-parents
gravage	gravure
hæmatopus	haematopus
hermite	ermite
hibous	hiboux
hormi	hormis
journals	journaux
kaempférie	kæmpférie
koelreutérie	kœlreutérie
lache	lâche
laendler	lændler
lætare	laetare
language	langage
l'appella	l'appela
lattitude	latitude
license	licence
litérature	littérature
mæstoso	maestoso
mæstria	maestria
mæstro	maestro
manoeuvr	manœuvr
marriage	mariage
méchament	méchamment
melaena	melæna
métoeque	métœque
millieu	milieu
minnesaenger	minnesænger
mirroir	miroir
mœur	mœurs
moeurs	mœurs
monoecie	monœcie
naevo-carcinome	nævo-carcinome
naevus	nævus
napoléonnien	napoléonien
napoléonnienne	napoléonienne
notament	notamment
nottament	notamment
nottamment	notamment
novae	novæ
nuitament	nuitamment
object	objet
obsèque	obsèques
occulaire	oculaire
occurence	occurrence
opuse	opus
paedère	pædère
paederia	pæderia
paedogenèse	pædogenèse
paedotribe	pædotribe
paeonia	pæonia
paralèlement	parallèlement
paralèle	parallèle
parmis	parmi
particpant	participant
picraena	picræna
platforme	plateforme
pneux	pneus
pokemon	pokémon
polyhèdre	polyèdre
polynome	polynôme
polynômia	polynomia
praemunire	præmunire
précédement	précédemment
prémice	prémices
pricipal	principal
puissament	puissamment
raeslérie	ræslérie
recencement	recensement
récitaux	récitals
recommend	recommand
récopense	récompense
rédibitoire	rédhibitoire
rédition	reddition
régaux	régals
relevaille	relevailles
rencpntre	rencontre
rendezvous	rendez-vous
renomée	renommée
renomé	renommé
rensselærite	rensselaerite
répis	répit
représaille	représailles
resencement	recensement
résonnance	résonance
retrouvailes	retrouvailles
reunion	réunion
rhoeadine	rhœadine
rhythm	rythme
roemérite	rœmérite
roentge	roentgen
roesslérite	rœsslérite
roestélie	rœstélie
roetlère	rœtlère
sarraux	sarraus
sayète	saynète
scævolisme	scaevolisme
scénete	scénette
schoenberguien	schœnberguien
schoenite	schœnite
schoenus	schœnus
semaille	semailles
soupirails	soupiraux
spacia	spatia
sphaerella	sphærella
sphaerite	sphærite
sphaerium	sphærium
sphaerobolus	sphærobolus
sphaerocarpe	sphærocarpe
sphaeropsidée	sphæropsidée
sphaeropsis	sphæropsis
sphaerothèque	sphærothèque
staehéline	stæhéline
suaeda	suæda
succédées	succédé
succédée	succédé
succint	succinct
supernovae	supernovæ
symmétr	symétrie
tæl	tael
taenia	tænia
taenioïde	tænioïde
ténebres	ténèbres
tenèbre	ténèbre
traffic	trafic
trés	très
trinome	trinôme
tutorial	tutoriel
tutoriaux	tutoriels
uraeus	uræus
vêpre	vêpres
