0eeeeeeeeeeeeeeeeeeeeeeeeeeeeeeeeeeee	e
0éééééééééééééééééééééééééééééééééééé	e
0jajajajajajajajajajajajajajajajajaja	ja
0neeneeneeneeneeneeneeneeneeneeneenee	nee
1.000m2	1.000 m²
1000m2	1000 m²
1000m3	1000 m³
100m2	100 m²
10A.-aansluiting	10A-aansluiting
10jarige	10-jarige
10m2	10 m²
10m3	10 m³
12jarige	12-jarige
12m2	12 m²
13jarige	13-jarige
14jarige	14-jarige
14m2	14 m²
150m2	150 m²
15jarige	15-jarige
15m2	15 m²
16jarige	16-jarige
16m2	16 m²
16-metergebied	16 metergebied
16 mm-camera	16mm-camera
17jarige	17-jarige
17m2	17 m²
18jarige	18-jarige
19eeeuw	19e eeuw
1cm	1 cm
1kg	1 kg
1km	1 km
1kW	1 kW
1m	1 m
1m2	1 m²
1m²	1 m²
1m30	1,30 m
1m3	1 m³
1m³	1 m³
1maal	1 maal
1maand	1 maand
1maart	1 maart
1mei	1 mei
1meter	1 meter
1mg	1 mg
1miljard	1 miljard
1miljoen	1 miljoen
1minuut	1 minuut
1ml	1 ml
1mm	1 mm
1-uurservice	1 uursservice
200m2	200 m²
2019-nCoV	SARS-CoV-2
20jarige	20-jarige
20kHz	20 kHz
20-kilometergebied	20 kilometergebied
20-kilometergebieden	20 kilometergebieden
20m3	20 m³
220V	220 V
230V	230 V
230 Volt	230 volt
24-uursbegeleiding	24 uursbegeleiding
24-uursbereikbaarheid	24 uursbereikbaarheid
24-uursbeschikbaarheid	24 uursbeschikbaarheid
24-uursbewaking	24 uursbewaking
24-uursconsultatie	24 uursconsultatie
24-uursdienst	24 uursdienst
24-uursdiensten	24 uursdiensten
24-uurs-economie	24 uurseconomie
24-uurseconomie	24 uurseconomie
24-uursgemiddelde	24 uursgemiddelde
24-uurshulp	24 uurshulp
24-uursopvang	24 uursopvang
24-uursprocedure	24 uursprocedure
24-uursservice	24 uursservice
24-uursstaking	24 uursstaking
24-uursstructuren	24 uursstructuren
24-uursstructuur	24 uursstructuur
24-uursverplichting	24 uursverplichting
24-uursverplichtingen	24 uursverplichtingen
24-uursvoorziening	24 uursvoorziening
24-uursvoorzieningen	24 uursvoorzieningen
24-uurszorg	24 uurszorg
24uurszorg	24 uurszorg
25-meter	25 meter
25meter	25 meter
25-meterbad	25 meterbad
27jarige	27-jarige
27mc	27 MC
2-cilinider	2-cilinder
2cm	2 cm
2cv	2CV
2-cylinder	2-cilinder
2kg	2 kg
2km	2 km
2m	2 m
2m3	2 m³
2maanden	2 maanden
2mei	2 mei
2meter	2 meter
2miljard	2 miljard
2miljoen	2 miljoen
2minuten	2 minuten
2ml	2 ml
2mm	2 mm
2ms	2 ms
2weken	2 weken
300m2	300 m²
30-kilometergebied	30 kilometergebied
30-kilometergebieden	30 kilometergebieden
30-km-zone	30km-zone
30m2	30 m²
35m2	35 m²
3cm	3 cm
3kg	3 kg
3km	3 km
3m2	3 m²
3maanden	3 maanden
3miljoen	3 miljoen
3minuten	3 minuten
3mm	3 mm
3-weekse	drieweekse
3weken	3 weken
400m2	400 m²
40+ers	40+'ers
40m2	40 m²
49km	49 km
4-cilinider	4-cilinder
4cm	4 cm
4-cylinder	4-cilinder
4GB	4 GB
4kg	4 kg
4km	4 km
4m2	4 m²
4m	4 m
4miljard	4 miljard
4miljoen	4 miljoen
4mm	4 mm
4uur	4 uur
5000m2	5000 m²
500m2	500 m²
500m3	500 m³
500meter	500 meter
50+er	50+'er
50+-er	50+'er
50+ers	50+'ers
50+-ers	50+'ers
50 km-zone	50km-zone
50m2	50 m²
50-meter	50 meter
50meter	50 meter
50-meterbad	50 meterbad
55+-er	55+'er
55+ers	55+'ers
55+-ers	55+'ers
5cm	5 cm
5jarigen	5-jarigen
5kg	5 kg
5km	5 km
5m2	5 m²
5m3	5 m³
5m	5 m
5meter	5 meter
5mg	5 mg
5miljard	5 miljard
5miljoen	5 miljoen
5minuten	5 minuten
5ml	5 ml
5mm	5 mm
600m2	600 m²
60+-er	60+'er
60+ers	60+'ers
60+-ers	60+'ers
60m2	60 m²
65+er	65+'er
65+-er	65+'er
65+ers	65+'ers
65+-ers	65+'ers
65+ kaart	65+-kaart
65+ kaarten	65+-kaarten
65m2	65 m²
65’plusser	65-plusser
65plusser	65-plusser
65’plussers	65-plussers
65plussers	65-plussers
6-cilinider	6-cilinder
6cm	6 cm
6-cylinder	6-cilinder
6kg	6 kg
6km	6 km
6m3	6 m³
6m	6 m
6maanden	6 maanden
6mei	6 mei
6miljoen	6 miljoen
6mm	6 mm
70m2	70 m²
75+-er	75+'er
75+ers	75+'ers
75+-ers	75+'ers
75km	75 km
75m2	75 m²
7cm	7 cm
7kg	7 kg
7km	7 km
7m	7 m
7maart	7 maart
7miljard	7 miljard
7mm	7 mm
80jarige	80-jarige
80km	80 km
80m2	80 m²
82km	82 km
85km	85 km
88km	88 km
8cm	8 cm
8kg	8 kg
8km	8 km
8m	8 m
8miljoen	8 miljoen
8mm	8 mm
90km	90 km
90m2	90 m²
95km	95 km
96kHz	96 kHz
9cm	9 cm
9km	9 km
9m	9 m
9mei	9 mei
9mm	9 mm
A1-lokaties	A1-locaties
A4-tje	A4'tje
A4tje	A4'tje
A4-tjes	A4'tjes
A4tjes	A4'tjes
A5-je	A5'je
A5je	A5'je
A5-jes	A5'jes
A5jes	A5'jes
a`	à
aaf	Aaf
aanbde	aan de
aanbonsen	aanbonzen
aangebrandt	aangebrand
aangedraait	aangedraaid
aangeduidt	aangeduid
aangeduit	aangeduid
aangedurft	aangedurfd
aangegroeit	aangegroeid
aangehaalt	aangehaald
aangekaard	aangekaart
aangeklaagdt	aangeklaagd
aangeklaagt	aangeklaagd
aangekleedt	aangekleed
aangekondigt	aangekondigd
aangelandt	aangeland
aangeleerdt	aangeleerd
aangeleert	aangeleerd
aangelegdt	aangelegd
aangelegt	aangelegd
aangelevert	aangeleverd
aangelijnt	aangelijnd
aangemeldt	aangemeld
aangemelt	aangemeld
aangemoedigdt	aangemoedigd
aangemoedigt	aangemoedigd
aangepakd	aangepakt
aangepasd	aangepast
aangepland	aangeplant
aangerandt	aangerand
aangerekent	aangerekend
aangeschafd	aangeschaft
aangescherpd	aangescherpt
aangespeelt	aangespeeld
aangespoelt	aangespoeld
aangespoort	aangespoord
aangesteldt	aangesteld
aangestelt	aangesteld
aangestuurdt	aangestuurd
aangestuurt	aangestuurd
aangetekent	aangetekend
aangetoont	aangetoond
aangevoerdt	aangevoerd
aangevoert	aangevoerd
aangevraagdt	aangevraagd
aangevraagt	aangevraagd
aangevuldt	aangevuld
aangevult	aangevuld
aangewakkert	aangewakkerd
aangewendt	aangewend
aangewent	aangewend
aangezegt	aangezegd
aankun	aankan
aantaal	aantal
aan`t	aan 't
aanvals	aanvals-
aanvoerdster	aanvoerster
abberant	aberrant
abberrant	aberrant
aberant	aberrant
aberatie	aberratie
aberaties	aberraties
aboriginals	Aboriginals
abusievelijke	abusieve
a-capella	a capella
accesoire	accessoire
accesoires	accessoires
accessiet	accessit
accessieten	accessits
accoderen	accorderen
accomodatie	accommodatie
accomodaties	accommodaties
accomodation	accommodatie
accomodeerde	accommodeerde
accomodeerden	accommodeerden
accomodeert	accommodeert
accomoderen	accommoderen
accoord	akkoord
accoorden	akkoorden
accupressuur	acupressuur
accupuncturist	acupuncturist
accupuncturisten	acupuncturisten
accupunctuur	acupunctuur
accutje	accuutje
accuut	acuut
acellerando	accelerando
acellereren	accelereren
acepteren	accepteren
achenebisj	achenebbisj
achenibbisj	achenebbisj
achterkomen	achter komen
achtien	achttien
achtiende	achttiende
achtienjarig	achttienjarig
achtienjarige	achttienjarige
achtienjarigen	achttienjarigen
achtneming	inachtneming
achttiend	achttiende
acht-uurjournaal	achtuurjournaal
acte de presence	acte de présence
actievieten	activiteiten
ade	de
ADHD-er	ADHD'er
ADHDer	ADHD'er
ADHD-ers	ADHD'ers
a.d.h.v	a.d.h.v.
adjudantchef	adjudant-chef
adjudantchefs	adjudant-chefs
adrem	ad rem
adviesbureau's	adviesbureaus
adviesburo	adviesbureau
aërobe	aerobe
aërodynamica	aerodynamica
aërodynamisch	aerodynamisch
aërodynamische	aerodynamische
aëroob	aeroob
aërosol	aerosol
afdalingske	afdalinkje
afdalingskes	afdalinkjes
afgebakent	afgebakend
afgebeeldt	afgebeeld
afgebeelt	afgebeeld
afgebeldt	afgebeld
afgebouwt	afgebouwd
afgebrandt	afgebrand
afgebrant	afgebrand
afgedraait	afgedraaid
afgedroogt	afgedroogd
afgehaalt	afgehaald
afgehad	af gehad
afgehandeldt	afgehandeld
afgehandelt	afgehandeld
afgehardt	afgehard
afgekeurdt	afgekeurd
afgekeurt	afgekeurd
afgekoelt	afgekoeld
afgekondigt	afgekondigd
afgekoppelt	afgekoppeld
afgelegdt	afgelegd
afgelegt	afgelegd
afgeleit	afgeleid
afgeleverdt	afgeleverd
afgelevert	afgeleverd
afgelopend	afgelopen
afgelopende	afgelopen
afgemeldt	afgemeld
afgereist	afgereisd
afgerekent	afgerekend
afgeremt	afgeremd
afgerondt	afgerond
afgeschafd	afgeschaft
afgeschermt	afgeschermd
afgescheurdt	afgescheurd
afgescheurt	afgescheurd
afgeschildert	afgeschilderd
afgesloofdt	afgesloofd
afgespeelt	afgespeeld
afgespoelt	afgespoeld
afgesteldt	afgesteld
afgestelt	afgesteld
afgestemt	afgestemd
afgestrafd	afgestraft
afgestudeert	afgestudeerd
afgetekent	afgetekend
afgevaardigdt	afgevaardigd
afgevoert	afgevoerd
afgevraagt	afgevraagd
afgevuurt	afgevuurd
afgewendt	afgewend
afgewerkd	afgewerkt
afgewisselt	afgewisseld
afgezaagt	afgezaagd
afgezegdt	afgezegd
afgezegt	afgezegd
afgezondert	afgezonderd
afhad	af had
afhadden	af hadden
afleidingsmanoevre	afleidingsmanoeuvre
afleidingsmanouvre	afleidingsmanoeuvre
Africa's	Afrika's
afscheidskado	afscheidscadeau
afscheidstoernee	afscheidstournee
afschuwlijk	afschuwelijk
afschuwlijke	afschuwelijk
afweet	af weet
afwil	af wil
agoravobie	agorafobie
agrarier	agrariër
agrariers	agrariërs
agregaat	aggregaat
agro-industriele	agro-industriële
ahaerlebnis	aha-erlebnis
aïda	Aïda
aidspatient	aidspatiënt
aidspatienten	aidspatiënten
aikidoend	aikidoënd
aikidoexamen	aikido-examen
aikidoexamens	aikido-examens
aio-stelsel	aiostelsel
air bag	airbag
air-conditioning	airconditioning
aircotje	aircootje
Airship	Luchtschip
ajacied	Ajacied
ajacieden	Ajacieden
Ajax'	Ajaxs
ajurveda	ayurveda
akkordeerde	accordeerde
akkordeert	accordeert
akkorderen	accorderen
akku	accu
akoord	akkoord
akordeerde	accordeerde
akordeert	accordeert
akount	account
akribisch	acribisch
akrobaat	acrobaat
akrobatie	acrobatie
aktentas	aktetas
aktie	actie
aktief	actief
akties	acties
aktieve	actieve
aktiviteit	activiteit
aktiviteiten	activiteiten
akwisitie	acquisitie
Aldi	ALDI
algorithm	algoritme
algorithme	algoritme
algorithmen	algoritmen
algorithmes	algoritmes
algorithms	algoritmes
allem	alle
allerei	allerlei
allert	alert
àlles	álles
allroundschaatsert	allroundschaatser
alluminium	aluminium
alluminiumfolie	aluminiumfolie
A-lokatie	A-locatie
alover	al over
àls	áls
àltijd	áltijd
altijdgroenend	altijdgroen
ambachtschool	ambachtsschool
ambtenarencorps	ambtenarenkorps
ambulanc	ambulance
amer	Amer
american football	American football
America's	Amerika's
Ampe`re	Ampère
ana	aan
analise	analyse
analyst	analist
ànder	ánder
àndere	ándere
ànderen	ánderen
ànders	ánders
anderssoortige	andersoortige
andijviestampot	andijviestamppot
André's	Andrés
androidoprichter	Androidoprichter
androidtoestel	Androidtoestel
androidtoestellen	Androidtoestellen
ångströms	ångström
angstverwekkend	angstwekkend
annemiek	Annemiek
annemieke	Annemieke
Antartica	Antarctica
anti-abortus	antiabortus
anti-Amerikanisme	antiamerikanisme
antiasthmatica	antiastmatica
anti-autoritair	antiautoritair
anti-autoritaire	antiautoritaire
antidiscriminatiebureau's	antidiscriminatiebureaus
anti-rookbeleid	antirookbeleid
anti-rooklobby	antirooklobby
anti-rookwet	antirookwet
anulair	annulair
Apache-helicopter	Apache-helikopter
apekolonie	apenkolonie
apekolonies	apenkolonies
apengapen	apegapen
apenootjes	apennootjes
apentrots	apetrots
a-politiek	apolitiek
appe`l	appel
Appe`l	Appel
a propos	à propos
arbeidsbureau's	arbeidsbureaus
arbeidsburo	arbeidsbureau
architectenburo	architectenbureau
arende	arenden
artsencorps	artsenkorps
asbroek	Asbroek
Asgard	Asgaard
ashkenazische	Asjkenazische
assistentscheidsrechter	assistent-scheidsrechter
assistentscheidsrechters	assistent-scheidsrechters
astronautencorps	astronautenkorps
Asus	ASUS
aswoensdag	Aswoensdag
ate	aten
Atje	Atjeh
attache	attaché
attachée	attaché
attache's	attachés
attaches	attachés
attack	attaque
attacker	aanvaller
attackers	aanvallers
attacks	attaques
au serieux	au sérieux
au-serieux	au sérieux
au-sérieux	au sérieux
autoinbraken	auto-inbraken
auto`s	auto's
avantgardistisch	avant-gardistisch
avantgardistische	avant-gardistische
avondland	Avondland
avondster	Avondster
ayatollah's	ayatollahs
azaleas	azalea's
azerty-klavier	azertyklavier
AZERTY-klavier	azertyklavier
azerty-klavieren	azertyklavieren
AZERTY-klavieren	azertyklavieren
azerty-klaviertje	azertyklaviertje
AZERTY-klaviertje	azertyklaviertje
azerty-klaviertjes	azertyklaviertjes
AZERTY-klaviertjes	azertyklaviertjes
azerty-toetsenbord	azertytoetsenbord
AZERTY-toetsenbord	azertytoetsenbord
azerty-toetsenborden	azertytoetsenborden
AZERTY-toetsenborden	azertytoetsenborden
azerty-toetsenbordje	azertytoetsenbordje
AZERTY-toetsenbordje	azertytoetsenbordje
azerty-toetsenbordjes	azertytoetsenbordjes
AZERTY-toetsenbordjes	azertytoetsenbordjes
azimuth	azimut
Baai van Mont-Saint-Michel	Baai van Mont Saint-Michel
baand	baan
baardde	baarde
baby`s	baby's
Bachhus	Bacchus
Bachus	Bacchus
backups	back-ups
bajessen	bajesen
bakske	bakje
bakskes	bakjes
balcon	balkon
Balkenende-norm	balkenendenorm
Balkenendenorm	balkenendenorm
balladendichter	balladedichter
balladesdichter	balladedichter
bama-structuur	bamastructuur
bankske	bankje
banus	Banus
Bargercompascuum	Barger-Compascuum
barri`ere	barrière
barrie`re	barrière
barrie`res	barrières
barrie`rewerking	barrièrewerking
bassa	Bassa
B&b	B&B
B+B	B&B
beantwoort	beantwoord
beboedt	beboet
bebosd	bebost
bedachdt	bedacht
bedankd	bedankt
bed-bad-en-brooddiscussie	bed-bad-brooddiscussie
bed-bad-en-brooddiscussies	bed-bad-brooddiscussies
bedevaartsoort	bedevaartsoord
bediendenkamers	bediendekamers
bedodt	bedot
bedrijfsbrandweercorps	bedrijfsbrandweerkorps
bedrijvenlokaties	bedrijvenlocaties
begond	begon
begonde	begon
begripvorming	begripsvorming
begripvormingen	begripsvormingen
begroed	begroet
beheersd	beheerst
behoet	behoed
béide	béíde
beijing	Beijing
bekenen	bekennen
bekkies	bekjes
bekleet	bekleed
belangerijkste	belangrijkste
belanghebbendes	belanghebbenden
belant	beland
belastingopgaves	belastingopgaven
belastingsbrief	belastingbrief
belastingsdienst	Belastingdienst
belastingsgelden	belastinggelden
belastingstrucs	belastingtrucs
belder	Belder
beled	belet
beleidsniveau's	beleidsniveaus
belgenmop	Belgenmop
belgenmoppen	Belgenmoppen
bemensd	bemenst
beperkd	beperkt
bepland	beplant
bepleidt	bepleit
berceau's	berceaus
bereikd	bereikt
bereinteressant	bere-interessant
bereit	bereid
bereninteressant	bere-interessant
bergske	bergje
bergskes	bergjes
berichd	bericht
beroepsexam	beroepsexamen
beschermingsniveau's	beschermingsniveaus
beschimperd	beschimpt
beschud	beschut
beschudt	beschut
besefd	beseft
beslisd	beslist
beslisdt	beslist
beslotend	besloten
besmed	besmet
bestaanrecht	bestaansrecht
bestande	bestaande
besteet	besteed
bestrafd	bestraft
bestratingwerkzaamheden	bestratingswerkzaamheden
besturingsysteem	besturingssysteem
bestuursrechterlijk	bestuursrechtelijk
be`ta	bèta
be`ta-	bèta-
Be`ta	Bèta
bêta	bèta
betablokker	bètablokker
bétablokker	bètablokker
betablokkers	bètablokkers
bétablokkers	bètablokkers
betanddeel	bestanddeel
be`ta-opleidingen	bètaopleidingen
bèta-opleidingen	bètaopleidingen
be`taprofiel	bètaprofiel
be`taprofielen	bètaprofielen
be`ta's	bèta's
be`ta-studies	bètastudies
be`tastudies	bètastudies
be`ta-vakken	bètavakken
be`tavakken	bètavakken
beteert	beteerd
betrapd	betrapt
beugelbh	beugel-bh
beugelbh's	beugel-bh's
beukenootjes	beukennootjes
bevad	bevat
beveiliginsincident	beveiligingsincident
beveiliginsincidenten	beveiligingsincidenten
bevolkd	bevolkt
bevrijt	bevrijd
bevrozen	bevroren
bewolkd	bewolkt
bezad	bezat
bezinestations	benzinestations
bezochd	bezocht
bezoekske	bezoekje
big-bang-theorie	bigbangtheorie
big-bangtheorie	bigbangtheorie
bigbang-theorie	bigbangtheorie
bijbelplaatsen	Bijbelplaatsen
bijde	bij de
bijdehandte	bijdehante
bijdeze	bij deze
bij-effect	bijeffect
bij-effecten	bijeffecten
bijgelegt	bijgelegd
bijgeschaaft	bijgeschaafd
bijgesteldt	bijgesteld
bijgestelt	bijgesteld
bijgevoedt	bijgevoed
bijgevoegt	bijgevoegd
bijgevult	bijgevuld
bijgewerkd	bijgewerkt
bijgewoont	bijgewoond
Bijiage	Bijlage
bijiagen	bijlagen
Bijiagen	Bijlagen
bijna-dood-ervaring	bijna-doodervaring
bijnadoodervaring	bijna-doodervaring
bijna-dood-ervaringen	bijna-doodervaringen
bijnadoodervaringen	bijna-doodervaringen
Bijoux	Bijous
bijstanduitkeringen	bijstandsuitkeringen
bijvoorbeel	bijvoorbeeld
bijvoorbeeldde	bijvoorbeeld de
bìnnen	bínnen
binnend	binnen
binnengehaalt	binnengehaald
bioindustrie	bio-industrie
bioinformatica	bio-informatica
bioinformatics	bio-informatica
b-kant	B-kant
b-kantje	B-kantje
b-kantjes	B-kantjes
bleutooth	bluetooth
blindde	blinde
blindegeleidehond	blindengeleidehond
blokske	blokje
blokskes	blokjes
blootgelegt	blootgelegd
blootgestelt	blootgesteld
bobbies	bobby's
boe-geroep	boegeroep
boekske	boekje
boekskes	boekjes
boete's	boetes
bolland	Bolland
bolleman	Bolleman
bolman	Bolman
bolsjevistische	bolsjewistische
bonde	blonde
bondsdagverkiezingen	Bondsdagverkiezingen
bonekamp	Bonekamp
bon-vivant	bon vivant
boodschappies	boodschapjes
boogywoogy	boogiewoogie
booi	boot
Bordeaux's	Bordeauxs
bors	Bors
borstpieren	borstspieren
boschage	bosschage
boschages	bosschages
bosfeeen	bosfeeën
bosjesman	Bosjesman
bosjesmannen	Bosjesmannen
boske	bosje
boskes	bosjes
Bosni	Bosnië
bouillabaise	bouillabaisse
Bourouillaan	Bourouilllaan
bouter	bouder
bouwlokatie	bouwlocatie
bouwlokaties	bouwlocaties
bovend	boven
brakwater-	brak water
brandweercorps	brandweerkorps
brandweercorpsen	brandweerkorpsen
breden	brede
brexit-onderhandeling	brexitonderhandeling
brexit-onderhandelingen	brexitonderhandelingen
brexit-referendum	brexitreferendum
brexit-strategie	brexitstrategie
brinnummer	BRIN-nummer
Brinnummer	BRIN-nummer
brinnummers	BRIN-nummers
bristol	Bristol
broeikasteffect	broeikaseffect
broekske	broekje
Brommelia	Bromelia
brommert	brommer
bronen	bronnen
broodje-aap	broodje aap
broodje-aap-verhaal	broodjeaapverhaal
broodje-aapverhaal	broodjeaapverhaal
broodje-aap-verhalen	broodjeaapverhalen
broodje-aapverhalen	broodjeaapverhalen
broque	brogue
broques	brogues
brugske	brugje
brutus	Brutus
Bruxelles	Brussel
BTW-aangifte	btw-aangifte
BTW-aangiften	btw-aangiften
BTW-aangiftes	btw-aangiftes
BTW-activiteit	btw-activiteit
BTW-administratie	btw-administratie
BTW-afdracht	btw-afdracht
BTW-afdrachten	btw-afdrachten
BTW-aftrek	btw-aftrek
BTW-attest	btw-attest
BTW-bedrag	btw-bedrag
BTW-bedragen	btw-bedragen
BTW-behandeling	btw-behandeling
BTW-belaste	btw-belaste
BTW-bepalingen	btw-bepalingen
BTW-betalingen	btw-betalingen
BTW-carrousel	btw-carrousel
BTW-claims	btw-claims
BTW-code	btw-code
btw-coden	btw-codes
BTW-comité	btw-comité
BTW-Comité	Btw-comité
BTW-compensatie	btw-compensatie
BTW-compensatiefonds	btw-compensatiefonds
BTW-Compensatiefonds	Btw-compensatiefonds
BTW-compensatieregeling	btw-compensatieregeling
BTW-component	btw-component
BTW-constructie	btw-constructie
BTW-constructies	btw-constructies
BTW-controlekantoor	btw-controlekantoor
BTW-correctie	btw-correctie
BTW-declaraties	btw-declaraties
BTW-doeleinden	btw-doeleinden
BTW-druk	btw-druk
BTW-eenheid	btw-eenheid
BTW-factuur	btw-factuur
BTW-fraude	btw-fraude
BTW-gegevens	btw-gegevens
BTW-gelden	btw-gelden
BTW-grondslag	btw-grondslag
BTW-heffing	btw-heffing
BTW-identificatienummer	btw-identificatienummer
BTW-identificatienummers	btw-identificatienummers
BTW-informatie	btw-informatie
BTW-inkomsten	btw-inkomsten
BTW-instrument	btw-instrument
BTW-kantoor	btw-kantoor
BTW-kosten	btw-kosten
BTW-kwestie	btw-kwestie
BTW-lasten	btw-lasten
BTW-lease	btw-lease
BTW-loket	btw-loket
BTW-maatregel	btw-maatregel
BTW-maatregelen	btw-maatregelen
BTW-middel	btw-middel
BTW-middelen	btw-middelen
BTW-nultarief	btw-nultarief
BTW-nummer	btw-nummer
BTW-nummers	btw-nummers
BTW-ondernemer	btw-ondernemer
BTW-ondernemers	btw-ondernemers
BTW-ontduiking	btw-ontduiking
BTW-ontvangsten	btw-ontvangsten
BTW-opbrengst	btw-opbrengst
BTW-opbrengsten	btw-opbrengsten
BTW-pakket	btw-pakket
BTW-percentage	btw-percentage
BTW-plicht	btw-plicht
BTW-plichtig	btw-plichtig
BTW-plichtige	btw-plichtige
BTW-plichtigen	btw-plichtigen
BTW-plichtigheid	btw-plichtigheid
BTW-problematiek	btw-problematiek
BTW-regelgeving	btw-regelgeving
BTW-regeling	btw-regeling
BTW-regelingen	btw-regelingen
BTW-regels	btw-regels
BTW-regime	btw-regime
BTW-reparatie	btw-reparatie
BTW-richtlijn	btw-richtlijn
BTW-Richtlijn	btw-richtlijn
BTW-richtlijnen	btw-richtlijnen
BTW-samenwerkingsverbanden	btw-samenwerkingsverbanden
BTW-schade	btw-schade
BTW-sfeer	btw-sfeer
BTW-stelsel	btw-stelsel
BTW-strategie	btw-strategie
BTW-systeem	btw-systeem
BTW-tarief	btw-tarief
BTW-tariefverlaging	btw-tariefverlaging
BTW-tarieven	btw-tarieven
BTW-teruggave	btw-teruggave
BTW-uitgaven	btw-uitgaven
BTW-verhoging	btw-verhoging
BTW-verhogingen	btw-verhoging
BTW-verlaging	btw-verlaging
BTW-verplichting	btw-verplichting
BTW-verplichtingen	btw-verplichtingen
BTW-verrekening	btw-verrekening
BTW-voordeel	btw-voordeel
BTW-vrij	btw-vrij
BTW-vrijstelling	btw-vrijstelling
BTW-vrijstellingen	btw-vrijstellingen
BTW-wetgeving	btw-wetgeving
buikske	buikje
búiten	búíten
buitend	buiten
bulo	BuLO
buls	Buls
bunde	bundel
bureau's	bureaus
Bureau's	Bureaus
bureaux	bureaus
burgelijk	burgerlijk
burgelijke	burgerlijke
burgemeesterscorps	burgemeesterskorps
burka	boerka
burkadraagsters	boerkadraagsters
burkah	boerka
burka's	boerka's
burka-verbod	boerkaverbod
burkaverbod	boerkaverbod
burkavrouw	boerkavrouw
burkavrouwen	boerkavrouwen
burlesque	burlesk
buroblad	bureaublad
buro	bureau
burocraten	bureaucraten
burocratie	bureaucratie
burocratisch	bureaucratisch
burocratische	bureaucratische
burokratie	bureaucratie
burokratische	bureaucratische
burootje	bureautje
burootjes	bureautjes
buro's	bureaus
buros	bureaus
burostoel	bureaustoel
burqa	boerka
buske	busje
Bussummer	Bussumer
buter	Buter
cadeau's	cadeaus
Cadeau's	Cadeaus
cadeaux	cadeaus
cado	cadeau
cadootje	cadeautje
cadootjes	cadeautjes
caf	café
cafe's	cafés
café's	cafés
caffeïne-arm	cafeïnearm
caffeïnearm	cafeïnearm
caffeïne-arme	cafeïnearme
caffeïnearme	cafeïnearme
caffeine	cafeïne
caffeïne	cafeïne
caissiere	caissière
caissie`re	kassière
caissieres	caissières
Calimero-complex	calimerocomplex
calligrafie	kalligrafie
camera`s	camera's
Capucijnen	Kapucijnen
capucijners	kapucijners
carameliseren	karamelliseren
caramelliseren	karamelliseren
caravanserai	karavanserai
caravanserais	karavanserais
carière	carrière
cariëre	carrière
carierre	carrière
carièrre	carrière
cariërre	carrière
carri	carrière
carrie`re	carrière
carrie`re-	carrière-
carriere	carrière
carrie`remogelijkheden	carrièremogelijkheden
carrie`reperspectief	carrièreperspectief
carrie`res	carrières
carrie`reverloop	carrièreverloop
cassière	caissière
cassières	caissières
catastrophe	catastrofe
catastrophes	catastrofes
catharijne	Catharijne
c++	C++
CDA-er	CDA'er
CDA-ers	CDA'ers
cd`s	cd's
centrale-bankpresidenten	centralebankpresidenten
chateau briand	chateaubriand
chateau's	chateaus
checkboekje	chequeboekje
chefkok	chef-kok
chefkoks	chef-koks
cher	Cher
chicque	chic
chihuaha	chihuahua
ChristenUnie-lid	ChristenUnielid
Churchillaan	Churchilllaan
cilinidervormig	cilindervormig
Cis-Kaukasië	Ciskaukasië
Cites	CITES
Cites-conferentie	CITES-conferentie
Cites-verdrag	CITES-verdrag
clarence	Clarence
claxoneren	claxonneren
claxonerend	claxonnerend
claxonerende	claxonnerende
cliché-beeld	clichébeeld
cliche	cliché
cliché's	clichés
cliente`le	clientèle
cm2	cm²
cm3	cm³
CMS-systemen	CMS'en
CO²	CO₂
CO²-heffing	CO₂-heffing
Co2-uitstoot	CO2-uitstoot
cocaineaffaire	cocaïneaffaire
cocaine	cocaïne
cocainegebruik	cocaïnegebruik
cocainehandel	cocaïnehandel
cocainemaffia	cocaïnemaffia
cockerspaniel	cockerspaniël
cocker spaniël	cockerspaniël
cockerspaniels	cockerspaniëls
cockneydialect	Cockneydialect
codeine	codeïne
coëducatie	co-educatie
coefficient	coëfficiënt
coefficienten	coëfficiënten
coënzym	co-enzym
coëxisteerde	co-existeerde
coexistentie	co-existentie
coëxistentie	co-existentie
coëxisteren	co-existeren
coitaal	coïtaal
coitale	coïtale
coiteren	coïteren
coïtus interruptus	coitus interruptus
cojote	coyote
colaboreren	collaboreren
colage	collage
colatje	colaatje
cold-turkeymethode	coldturkeymethode
colibacterien	colibacteriën
collage-achtige	collageachtige
collectoritem	collector's item
collectors item	collector's item
collectors-item	collector's item
collectorsitem	collector's item
collega`s	collega's
college's	colleges
collet	kollet
colokatie	colocatie
Colokatie	Colocatie
coming out	coming-out
comit	comité
commenters	commentatoren
communities	community's
compact camera	compactcamera
compact-camera	compactcamera
compactdisc	compact disc
compactdiscs	compact discs
companion	compagnon
comperatief	comparatief
comperatieve	comparatieve
compjuter	computer
conan	canon
concièrge	conciërge
concièrges	conciërges
conducteurscorps	conducteurskorps
consierge	conciërge
consierges	conciërges
consultatiebureau's	consultatiebureaus
Consultatiebureau's	Consultatiebureaus
consultatieburo	consultatiebureau
controle's	controles
convooien	konvooien
convooi	konvooi
coo	COO
coòrdinatie	coördinatie
coòrdinator	coördinator
co-piloot	copiloot
co-piloten	copiloten
così	Così
coulissenlandschap	coulisselandschap
coulissenlandschapje	coulisselandschapje
coulissenlandschapjes	coulisselandschapjes
coulissenlandschappen	coulisselandschappen
coupe's	coupés
coupé's	coupés
Covid-19	COVID-19
crapule	crapuul
cre`che	crèche
crêche	crèche
cre`ches	crèches
creditcrisis	kredietcrisis
cre`me	crème
crême	crème
crepezolen	crêpezolen
crepezool	crêpezool
Croatisch	Kroatisch
croque madame	croque-madame
croque madames	croque-madames
croque monsieur	croque-monsieur
croque monsieurs	croque-monsieurs
cruise-control	cruisecontrol
cruiseship	cruiseschip
CU-er	CU'er
CU-ers	CU'ers
Curacaose	Curaçaose
cylinder	cilinder
cylinderinhoud	cilinderinhoud
cylinders	cilinders
cylindervormige	cilindervormige
cylindrisch	cilindrisch
cylindrische	cilindrische
cylinidervormig	cilindervormig
cymbalen	cimbalen
D66-er	D66'er
D66-ers	D66'ers
d66-fractie	D66-fractie
daagskes	dagjes
daarn	daar
daarvòòr	daarvóór
dactyl	Dactyl
dag-nacht	dag-nachtritme
dagske	dagje
Dalì	Dalí
dalijk	dadelijk
da`n	dán
danook	dan ook
danske	dansje
da`s	dat is
da`t	dát
Da`t	Dát
dàt	dát
DDoS-aanval	ddos-aanval
dDoS-aanvallen	ddos-aanval
DDoS-aanvallen	ddos-aanvallen
dealing room	dealingroom
death metal	deathmetal
decentralisatieuitkering	decentralisatie-uitkering
decentralisatieuitkeringen	decentralisatie-uitkeringen
décolleté	decolleté
décor	decor
dédain	dedain
de`	dé
deernes	deernen
defacto	de facto
defensieuitgaven	defensie-uitgaven
deïnstallatie	de-installatie
deinstalleren	de-installeren
deïnstalleren	de-installeren
démarche	demarche
démarrage	demarrage
dènk	dénk
dènken	dénken
Denny`s	Denny's
département	departement
de-radicalisering	deradicalisering
derdegeneratie	derde generatie
dermatologist	dermatoloog
dertigersdillema	dertigersdilemma
de`s	dat is
desector	de sector
dese	deze
deser	dezer
desert	dessert
deserts	desserts
des gevallend	desgevallend
des konings	des Konings
deurs	tweedeurs
deva	Deva
d`huez	d'Huez
diagnostiseren	diagnosticeren
diakonessenhuis	diaconessenhuis
dichtgegroeidt	dichtgegroeid
dichtgeslibt	dichtgeslibd
dichtsbijzijnde	dichtstbijzijnde
dié	díé
díe	díé
dìe	díé
dienstplichtingen	dienstplichtigen
dieperliggend	dieper liggend
dieze	die ze
diezel	diesel
dijood-gefunctionaliseerd	di-joodgefunctionaliseerd
dil	dit
dingske	dingetje
dingskes	dingetjes
dinkytoy	dinky toy
dinkytoys	dinky toys
dioxine-achtige	dioxineachtige
diploma`s	diploma's
diplomatencorps	diplomatenkorps
discjockey	diskjockey
discjockeys	diskjockeys
diskant	discant
diskanten	discanten
diskman	discman
dislexie	dyslexie
disseminated	gedissemineerd
disseminate	dissemineren
disseminating	disseminerend
dissemination	disseminatie
dìt	dít
ditjaar	dit jaar
dj`s	dj's
djs	dj's
DJ`s	dj's
dm2	dm²
dm3	dm³
dna-onderzoek	DNA-onderzoek
docentencorps	docentenkorps
documentaire-achtige	documentaireachtige
dodehoek	dode hoek
doekske	doekje
doktor	dokter
donateuren	donateurs
dond	vond
doodgebloedt	doodgebloed
doodgegooit	doodgegooid
doo	door
doodvrie	doodvries
Doom3	Doom 3
doorde	door de
door-de-weekse	doordeweekse
door-en-door	door en door
doorgebrandt	doorgebrand
doorgedraait	doorgedraaid
doorgemeldt	doorgemeld
doorgereist	doorgereisd
doorgespeeldt	doorgespeeld
doorgespeelt	doorgespeeld
doorgestuurdt	doorgestuurd
doorgestuurt	doorgestuurd
doorgevoert	doorgevoerd
doorkruisd	doorkruist
dooske	doosje
dorpstraat	Dorpstraat
Down-syndroom	downsyndroom
drap	drab
d`r	haar
drie-en-een-half	drie en een half
driekwartier	drie kwartier
driesterren-	drie-
drietrapsrakket	drietrapsraket
drok	druk
dropouts	drop-outs
droppie	dropje
droppies	dropjes
Dr. Voigtstraatstraat	Dr. Voigtstraat
dubbelcd	dubbel-cd
dubbelcd's	dubbel-cd's
dubbeld	dubbel
ducktape	ducttape
ducktapes	ducttapes
ductape	ducttape
ductapes	ducttapes
duct-tape	ducttape
duct-tapes	ducttapes
duitland	Duitsland
dur	er
dutskes	dutjes
dvd`s	dvd's
DVD`s	dvd's
dwarslesie	dwarslaesie
dwarslesies	dwarslaesies
dyslectie	dyslexie
eau-de-vie	eau de vie
eau-de-vies	eau de vies
eaux-de-vie	eaux de vie
ebay	eBay
Ebola-virus	ebolavirus
e`cht	écht
ècht	écht
e`chte	échte
èchte	échte
Edelweis	Edelweiss
EEG-Richtlijn	EEG-richtlijn
EEG-Verdrag	EEG-verdrag
EEG-Verordening	EEG-verordening
-één	één
éé'n	één
eeneiïge	eeneiige
eeneiïg	eeneiig
eenvijfde	een vijfde
eetcafé's	eetcafés
effend	effen
effici	efficiënt
efteling	Efteling
eggetanden	eggentanden
ehbo	EHBO
EHBO-er	EHBO'er
EHBO-ers	EHBO'ers
eigend	eigen
eigengewin	eigen gewin
eigenrisico	eigen risico
ekende	bekende
electra	elektra
electricien	elektricien
electriciens	elektriciens
electriciteit	elektriciteit
electriciteitsbedrijf	elektriciteitsbedrijf
electriciteitsbedrijven	elektriciteitsbedrijven
electriciteitscentrale	elektriciteitscentrale
electriciteitscentrales	elektriciteitscentrales
electriciteitsleidingen	elektriciteitsleidingen
electriciteitsleverancier	elektriciteitsleverancier
electriciteitsmeter	elektriciteitsmeter
electriciteitsprijs	elektriciteitsprijs
electriciteitsverbruik	elektriciteitsverbruik
electriciteitsvoorziening	elektriciteitsvoorziening
electrische	elektrische
elekra	elektra
Elen	Ellen
elitecorps	elitekorps
e`lke	élke
ellend	ellende
elohim	Elohim
elton-john-bril	eltonjohnbril
Emancipatiekommissie	Emancipatiecommissie
emissie-arm	emissiearm
e`n	én
-én	én
energieverbuik	energieverbruik
enqu	enquête
enquetecommissie	enquêtecommissie
enquète	enquête
enqueteformulieren	enquêteformulieren
enqueteformulier	enquêteformulier
enqueterecht	enquêterecht
enqueteren	enquêteren
enquètes	enquêtes
enqueteurs	enquêteurs
enquette	enquête
enterprise-architectuur	enterprisearchitectuur
erch	erg
èrg	érg
etage's	etages
etappe's	etappes
etherpad	Etherpad
EtherPad	Etherpad
euri	euro
euri's	euro's
euro-biljetten	eurobiljetten
europarlementarier	Europarlementariër
Europarlementarier	Europarlementariër
europarlementariër	Europarlementariër
europarlementariers	Europarlementariërs
Europarlementariers	Europarlementariërs
europarlementariërs	Europarlementariërs
euro`s	euro's
euthanesie	euthanasie
euthaniseren	euthanaseren
euthansie	euthanasie
euthenasie	euthanasie
evidence-based	evidencebased
ex-aequo	ex aequo
examenopgaves	examenopgaven
excollega	ex-collega
ex-collegas	ex-collega's
excollega's	ex-collega's
excollegas	ex-collega's
excuser	verexcuseren
excusus	excuses
excuustrusen	excuustruzen
expeditiecorps	expeditiekorps
exploitatieuitgaven	exploitatie-uitgaven
exports	export
extrapyramidaal	extrapiramidaal
extra`s	extra's
extreem-rechts	extreemrechts
Faceboek	Facebook
facebookgroep	Facebookgroep
facultiet	faculteit
faecaaloccultbloedtest	fecaaloccultbloedtest
faeces	feces
Fallopii	fallopii
familieuitje	familie-uitje
familieuitstap	familie-uitstap
fanfarecorps	fanfarekorps
fant	fantasie
fants	fantasieën
favorite	favoriete
fbook	Facebook
F-droid	F-Droid
febo	FEBO
Februarij	februari
febru	februari
feërieke	feeërieke
feestlokatie	feestlocatie
fetisch	fetisj
fetish	fetisj
fietske	fietsje
fietskes	fietsjes
file's	files
financien	financiën
finnen	Finnen
flagship	vlaggenschip
flectie	flexie
fleske	flesje
flexiewoorden	flexies
flexiewoord	flexie
flexiewoordje	flexietje
flexiewoordjes	flexietjes
formatieuitbreiding	formatie-uitbreiding
fortis	Fortis
fosdem	FOSDEM
fotocopy	fotokopie
fotoexpositie	foto-expositie
fotografies	foto's
foto`s	foto's
Foto`s	Foto's
fourageren	foerageren
fraiche	fraîche
frankenstein	Frankenstein
frankskes	franken
frans	Frans
fraxodi	Fraxodi
freestylert	freestyler
frequent flier	frequent flyer
friendship	vriendschap
Friendship	Vriendschap
friese	Friese
friesland	Friesland
friestalige	Friestalige
friskes	frisjes
ftp-en	ftp'en
FTP-server	ftp-server
FTP-site	ftp-site
FTP-sites	ftp-sites
functieuitoefening	functie-uitoefening
functieuitrusting	functie-uitrusting
gaaike	gaaitje
Galápagoseilanden	Galapagoseilanden
galle	challe
gascylinder	gascilinder
gascylinders	gascilinders
gastouderbureau's	gastouderbureaus
Gaugin	Gauguin
g/cm3	g/cm³
GDV-lokatie	GDV-locatie
geaait	geaaid
geaardt	geaard
geabsorbeert	geabsorbeerd
geaccepteerdt	geaccepteerd
geaccepteert	geaccepteerd
geaccomodeerd	geaccommodeerd
geaccordeerdt	geaccordeerd
geaccordeert	geaccordeerd
geactiveert	geactiveerd
geadopteert	geadopteerd
geadt	geat
geadviseerdt	geadviseerd
geadviseert	geadviseerd
geamuseerdt	geamuseerd
geamuseert	geamuseerd
geanalyseert	geanalyseerd
geanimeerdt	geanimeerd
geannuleert	geannuleerd
geantwoordt	geantwoord
geantwoort	geantwoord
gearbeidt	gearbeid
gearresteerdt	gearresteerd
gearresteert	gearresteerd
gearriveert	gearriveerd
geassisteert	geassisteerd
geassocieert	geassocieerd
geautomatiseert	geautomatiseerd
geavanceert	geavanceerd
gebabbelt	gebabbeld
gebackupt	geback-upt
gebaldt	gebald
geband	gebannen
gebant	gebannen
gebasebald	gebaseballd
gebaseerdt	gebaseerd
gebaseert	gebaseerd
gebauwdt	gebauwd
gebeidt	gebeid
gebeldt	gebeld
gebelt	gebeld
gebeterdt	gebeterd
gebezigdt	gebezigd
gebezigt	gebezigd
geblaadt	geblaat
gebladert	gebladerd
gebleerd	geblèrd
geblendt	geblend
geblesseert	geblesseerd
gebloedt	gebloed
gebloeit	gebloeid
gebloemt	gebloemd
geblogt	geblogd
geblokkeerdt	geblokkeerd
geblokkeert	geblokkeerd
geblowt	geblowd
geblusd	geblust
geboeidt	geboeid
geboeit	geboeid
geboekd	geboekt
geboert	geboerd
gebombardeert	gebombardeerd
geboordt	geboord
geboort	geboord
geborduurt	geborduurd
geborgdt	geborgd
geborgt	geborgd
geborstelt	geborsteld
gebotvierd	botgevierd
geboudt	gebout
gebouwdt	gebouwd
gebouwt	gebouwd
gebrachd	gebracht
gebrandt	gebrand
gebrant	gebrand
gebreidt	gebreid
gebreit	gebreid
gebrepen	begrepen
gebroedt	gebroed
gebruikd	gebruikt
gebrusqueerd	gebruuskeerd
gebuist	gebuisd
gebundelt	gebundeld
gecasseerdt	gecasseerd
gecastreert	gecastreerd
gecensureerdt	gecensureerd
gecensureert	gecensureerd
gecentreerdt	gecentreerd
gecertificeert	gecertificeerd
gecharmeert	gecharmeerd
gecheckd	gecheckt
geciteert	geciteerd
geclaimt	geclaimd
gecoachd	gecoacht
gecodeert	gecodeerd
gecombineerdt	gecombineerd
gecombineert	gecombineerd
gecommiteerd	gecommitteerd
gecommitteert	gecommitteerd
gecommuniceert	gecommuniceerd
gecompenseerdt	gecompenseerd
gecompenseert	gecompenseerd
gecompliceerdt	gecompliceerd
gecompliceert	gecompliceerd
gecomponeert	gecomponeerd
geconcenteerd	geconcentreerd
geconcentreert	geconcentreerd
geconcludeert	geconcludeerd
geconditioneert	geconditioneerd
geconfigureert	geconfigureerd
geconfronteerdt	geconfronteerd
geconfronteert	geconfronteerd
geconstateert	geconstateerd
geconstrueert	geconstrueerd
geconsumeert	geconsumeerd
gecontacteert	gecontacteerd
gecontinueerdt	gecontinueerd
gecontinueert	gecontinueerd
gecontracteert	gecontracteerd
gecontroleerdt	gecontroleerd
gecontroleert	gecontroleerd
geconverteert	geconverteerd
gecoòrdineerde	gecoördineerde
gecoördineerdt	gecoördineerd
gecoördineert	gecoördineerd
gecorrigeert	gecorrigeerd
gecorrumpeerdt	gecorrumpeerd
gecrashd	gecrasht
gecreëerdt	gecreëerd
gecreëert	gecreëerd
gecruisd	gecruised
gecruist	gecruiset
gedaagt	gedaagd
gedaalt	gedaald
gedaande	gedane
gedaand	gedaan
gedachtengangen	gedachtegangen
gedachtengang	gedachtegang
gedachtenkronkel	gedachtekronkel
gedachtenkronkels	gedachtekronkels
gedachtensprongen	gedachtesprongen
gedachtenstappen	gedachtestappen
gedachtenstreep	gedachtestreep
gedachtenstreepje	gedachtestreepje
gedachtenstreepjes	gedachtestreepjes
gedachtenstrepen	gedachtestrepen
gedachtenwendingen	gedachtewendingen
gedagvaardt	gedagvaard
gedagvaart	gedagvaard
gedansd	gedanst
gedateert	gedateerd
gedeblokkeert	gedeblokkeerd
gedeclareert	gedeclareerd
gedeeldt	gedeeld
gedeelt	gedeeld
gedefiniëerd	gedefinieerd
gedefinieert	gedefinieerd
gedegradeert	gedegradeerd
gedeklasseerd	gedeclasseerd
gedeleted	gedeletet
gedemonstreert	gedemonstreerd
gedemonteert	gedemonteerd
gedempd	gedempt
gedeponeert	gedeponeerd
gedeporteert	gedeporteerd
gedesinfecteerdt	gedesinfecteerd
gedetailleert	gedetailleerd
gedetecteert	gedetecteerd
gediagnostiseerd	gediagnosticeerd
gediendt	gediend
gedient	gediend
gedigitaliseert	gedigitaliseerd
gedimdt	gedimd
gedimt	gedimd
gedirigeert	gedirigeerd
gediscrimineerdt	gediscrimineerd
gediscrimineert	gediscrimineerd
gediscussieert	gediscussieerd
gediskwalificeert	gediskwalificeerd
gedistilleert	gedistilleerd
gedoceert	gedoceerd
gedoelt	gedoeld
gedoemt	gedoemd
gedomineert	gedomineerd
gedompelt	gedompeld
gedoneert	gedoneerd
gedoodt	gedood
gedooft	gedoofd
gedoopd	gedoopt
gedoot	gedood
gedoseerdt	gedoseerd
gedoseert	gedoseerd
gedouchd	gedoucht
gedownloadt	gedownload
gedraaidt	gedraaid
gedraait	gedraaid
gedreigt	gedreigd
gedrilt	gedrild
gedroogden	gedroogde
gedroogdt	gedroogd
gedroogt	gedroogd
gedroomdt	gedroomd
gedroomt	gedroomd
gedrukd	gedrukt
gedubt	gedubd
geduidt	geduid
geduldt	geduld
gedult	geduld
gedumpd	gedumpt
gedupeert	gedupeerd
gedurft	gedurfd
geduurdt	geduurd
geduurt	geduurd
geduwdt	geduwd
geduwt	geduwd
geëerbiedigdt	geëerbiedigd
geëert	geëerd
geëigendt	geëigend
geëindigdt	geëindigd
geëindigt	geëindigd
geëisd	geëist
ge-emaild	ge-e-maild
geemaild	ge-e-maild
geënd	geënt
gèèn	géén
geenzins	geenszins
geerfd	geërfd
geerft	geërfd
geërft	geërfd
geërgerdt	geërgerd
geëvolueerdt	geëvolueerd
geëvolueert	geëvolueerd
geëxamineerdt	geëxamineerd
geëxecuteert	geëxecuteerd
geëxperimenteert	geëxperimenteerd
geëxpireerdt	geëxpireerd
geëxploiteerdt	geëxploiteerd
geëxporteert	geëxporteerd
gefaalt	gefaald
gefabriceert	gefabriceerd
gefaciliteert	gefaciliteerd
gefantaseerdt	gefantaseerd
gefascineert	gefascineerd
gefeliciteert	gefeliciteerd
gefietsd	gefietst
gefilmdt	gefilmd
gefilmt	gefilmd
gefiltert	gefilterd
gefinanciert	gefinancierd
gefingeerdt	gefingeerd
gefinishd	gefinisht
gefixeert	gefixeerd
geflankeert	geflankeerd
geflansd	geflanst
geflikkerdt	geflikkerd
geflikkert	geflikkerd
gefocusd	gefocust
geforceert	geforceerd
geformeerdt	geformeerd
geformeert	geformeerd
geformuleerdt	geformuleerd
geformuleert	geformuleerd
gefotografeerdt	gefotografeerd
gefotografeert	gefotografeerd
gefourageerd	gefoerageerd
gefractioneerdt	gefractioneerd
gefraudeert	gefraudeerd
gefreest	gefreesd
gefrituurdt	gefrituurd
gefronsd	gefronst
gefrustreert	gefrustreerd
gefundeert	gefundeerd
gegarandeerdt	gegarandeerd
gegarandeert	gegarandeerd
gegenereert	gegenereerd
gegijzelt	gegijzeld
gegooidt	gegooid
gegooit	gegooid
gegraveert	gegraveerd
gegrifd	gegrift
gegrilt	gegrild
gegroeit	gegroeid
gegromdt	gegromd
gegrondt	gegrond
gegront	gegrond
gegunt	gegund
gehaad	gehaat
gehaadt	gehaat
gehaaldt	gehaald
gehaalt	gehaald
gehadt	gehad
gehalveerdt	gehalveerd
gehalveert	gehalveerd
gehandeldt	gehandeld
gehandelt	gehandeld
gehandhaafdt	gehandhaafd
gehandhaaft	gehandhaafd
gehanteert	gehanteerd
gehart	gehard
gehat	gehad
geheelt	geheeld
geheidt	geheid
geheiligt	geheiligd
geheit	geheid
gehercalibreerde	geherkalibreerde
gehersenspoelt	gehersenspoeld
gehindert	gehinderd
gehoedt	gehoed
gehonoreert	gehonoreerd
gehoondt	gehoond
gehoopd	gehoopt
gehoordt	gehoord
gehoort	gehoord
gehousd	gehoused
gehoust	gehouset
gehuildt	gehuild
gehuilt	gehuild
gehuisvesd	gehuisvest
gehuldigt	gehuldigd
gehult	gehuld
gehuurdt	gehuurd
gehuurt	gehuurd
gehuwdt	gehuwd
gehuwt	gehuwd
gehydrateert	gehydrateerd
gehyped	gehypet
geïdentificeerdt	geïdentificeerd
geïdentificeert	geïdentificeerd
geïllustreerdt	geïllustreerd
geïllustreert	geïllustreerd
geïmpliceerdt	geïmpliceerd
geindustrialiseerde	geïndustrialiseerde
geïnformeerdt	geïnformeerd
geïnformeert	geïnformeerd
geïnspecteerdt	geïnspecteerd
geïnspireerdt	geïnspireerd
geïnspireert	geïnspireerd
geinstalleerd	geïnstalleerd
geïnstalleerdt	geïnstalleerd
geïnstalleert	geïnstalleerd
geïntegreerdt	geïntegreerd
geïntegreert	geïntegreerd
geïnteresseerdt	geïnteresseerd
geïnteresseert	geïnteresseerd
geïnterpreteert	geïnterpreteerd
geïnt	geïnd
geintimideerd	geïntimideerd
geïntregeerd	geïntegreerd
geïntroduceerdt	geïntroduceerd
geïntroduceert	geïntroduceerd
geïnvesteert	geïnvesteerd
geïoniseerdt	geïoniseerd
geïsoleerdt	geïsoleerd
geïsoleert	geïsoleerd
gejaagdt	gejaagd
gejaagt	gejaagd
gejad	gejat
gejuichd	gejuicht
gejuigd	gejuicht
gejuig	gejuich
gekamt	gekamd
gekand	gekant
gekantelt	gekanteld
gekarakteriseert	gekarakteriseerd
gekarameliseerde	gekaramelliseerde
gekarameliseerd	gekaramelliseerd
gekastijdt	gekastijd
gekeert	gekeerd
gekendt	gekend
geken	gekeken
gekenmerkd	gekenmerkt
gekent	gekend
gekerft	gekerfd
gekeurdt	gekeurd
gekeurt	gekeurd
gèk	gék
gekiepert	gekieperd
geklaagt	geklaagd
geklaart	geklaard
geklasseerdt	geklasseerd
gekleedt	gekleed
gekleeft	gekleefd
gekleet	gekleed
geklemt	geklemd
gekleurt	gekleurd
gekluistert	gekluisterd
geknaldt	geknald
geknalt	geknald
gekneedt	gekneed
gekneust	gekneusd
geknoeit	geknoeid
geknuffelt	geknuffeld
geknutselt	geknutseld
gekoelt	gekoeld
gekoestert	gekoesterd
gekolft	gekolfd
gekookd	gekookt
gekopieerdt	gekopieerd
gekopieert	gekopieerd
gekoppeldt	gekoppeld
gekoppelt	gekoppeld
gekrabt	gekrabd
gekromdt	gekromd
gekromt	gekromd
gekroont	gekroond
gekruisd	gekruist
gekrult	gekruld
gekudt	gekut
gekuisd	gekuist
gekundt	gekund
gekunt	gekund
gekwalificeert	gekwalificeerd
gekweekd	gekweekt
gekweldt	gekweld
gekwelt	gekweld
gekwetsd	gekwetst
gelabelt	gelabeld
gelanceert	gelanceerd
gelandt	geland
gelant	geland
gelasd	gelast
geledende	geldende
geledend	geleden
geled	gelet
geledt	gelet
geleeft	geleefd
geleegt	geleegd
geleent	geleend
gelegdt	gelegd
gelegerdt	gelegerd
gelegt	gelegd
geleit	geleid
geleveldt	geleveld
geleverdt	geleverd
gelevert	geleverd
gelezende	gelezen
gelezend	gelezen
gelijkheidwaardigheid	gelijkwaardigheid
gelijmdt	gelijmd
gelijmt	gelijmd
geliked	geliket
gelimiteerdt	gelimiteerd
gelimiteert	gelimiteerd
gelinkd	gelinkt
gelobt	gelobd
gelocaliseerd	gelokaliseerd
gelogeert	gelogeerd
gelogt	gelogd
geloodsd	geloodst
geloondt	geloond
geloost	geloosd
gelosd	gelost
geluidt	geluid
geluistert	geluisterd
geluit	geluid
gelukd	gelukt
Gelukkiglijk	gelukkig
gelult	geluld
gelunchd	geluncht
gelynchd	gelyncht
gemaait	gemaaid
gemaakd	gemaakt
gemaakdt	gemaakt
gemachtigt	gemachtigd
gemaildt	gemaild
gemailt	gemaild
gemakske	gemak
gemakt	gemaakt
gemandt	gemand
gemanipuleert	gemanipuleerd
gemankeerdt	gemankeerd
gemanoevreerd	gemanoeuvreerd
gemanouvreerd	gemanoeuvreerd
gemarkeert	gemarkeerd
gemartelt	gemarteld
gemasseert	gemasseerd
gematigt	gematigd
gemeent	gemeend
gemeldt	gemeld
gemelt	gemeld
gemendt	gemend
gemenerikken	gemeneriken
gemengdt	gemengd
gemen	gemeen
gemengt	gemengd
gemeniriken	gemeneriken
gement	gemend
gemerkd	gemerkt
gemerkdt	gemerkt
gemetselt	gemetseld
gemiddeldt	gemiddeld
gemiddelt	gemiddeld
geminimaliseert	geminimaliseerd
gemisd	gemist
gemixd	gemixt
gemodificeert	gemodificeerd
gemoeit	gemoeid
gemoldt	gemold
gemolt	gemold
gemonitort	gemonitord
gemonteerdt	gemonteerd
gemonteert	gemonteerd
gemoordt	gemoord
gemotiveert	gemotiveerd
gemund	gemunt
gemundt	gemunt
genaait	genaaid
genadert	genaderd
genagelt	genageld
genante	gênante
genant	gênant
genânt	gênant
geneesmiddelenwet	Geneesmiddelenwet
genegeerdt	genegeerd
genegeert	genegeerd
geneigt	geneigd
genestelt	genesteld
geneukd	geneukt
geneukdt	geneukt
Gene`ve	Genève
genied	geniet
geniedt	geniet
genie-officieren	genieofficieren
genie-officier	genieofficier
genoemdt	genoemd
genoemt	genoemd
genomende	genoemde
genomend	genoemd
genomineert	genomineerd
genoodzaakd	genoodzaakt
genoteerdt	genoteerd
genoteert	genoteerd
genuanceert	genuanceerd
genudt	genut
genummert	genummerd
genuttigt	genuttigd
geobsedeert	geobsedeerd
geobserveert	geobserveerd
geoefendt	geoefend
geoefent	geoefend
geofferdt	geofferd
geoffert	geofferd
geolieden	geoliede
geoordeeldt	geoordeeld
geoordeelt	geoordeeld
geoorlooft	geoorloofd
geopenbaardt	geopenbaard
geopenbaart	geopenbaard
geopent	geopend
geopereerdt	geopereerd
geopereert	geopereerd
geopperdt	geopperd
geoppert	geopperd
geoptimaliseert	geoptimaliseerd
georchestreerde	georkestreerde
georchestreerd	georkestreerd
geordent	geordend
geordonneerdt	geordonneerd
georganiseerdt	georganiseerd
georganiseert	georganiseerd
geörienteerde	georiënteerde
geörienteerd	georiënteerd
geoxideerdt	geoxideerd
geoxideert	geoxideerd
gepaart	gepaard
gepakd	gepakt
geparkeerdt	geparkeerd
geparkeert	geparkeerd
gepasseerdt	gepasseerd
gepasseert	gepasseerd
gepatenteert	gepatenteerd
gepeilt	gepeild
gepeldt	gepeld
gepelt	gepeld
gepersd	geperst
gepersonaliseert	gepersonaliseerd
gepint	gepind
geplaagt	geplaagd
geplaatsd	geplaatst
gepledt	geplet
gepleegt	gepleegd
gepleid	gepleit
geplempdt	geplempt
gepleurdt	gepleurd
geplooit	geplooid
geplundert	geplunderd
gepolijsd	gepolijst
gepolsd	gepolst
gepompd	gepompt
gepoogt	gepoogd
gepositioneert	gepositioneerd
gepraktizeerd	gepraktiseerd
geprepareert	geprepareerd
gepresenteerdt	gepresenteerd
gepresenteert	gepresenteerd
gepresteert	gepresteerd
geprijst	geprijsd
geprikkelt	geprikkeld
geprobeerdt	geprobeerd
geprobeert	geprobeerd
geprocedeert	geprocedeerd
geproduceerdt	geproduceerd
geproduceert	geproduceerd
geproeft	geproefd
geprofiteert	geprofiteerd
geprogrammeert	geprogrammeerd
geprojecteert	geprojecteerd
gepromoveert	gepromoveerd
gepropageert	gepropageerd
geprotesteert	geprotesteerd
gepubliceert	gepubliceerd
geraadpleegt	geraadpleegd
geraakd	geraakt
geraamt	geraamd
geraced	geracet
geragdt	geragd
geramt	geramd
gerapporteert	gerapporteerd
gerapst	geraspt
gereageerdt	gereageerd
gereageert	gereageerd
gerealiseert	gerealiseerd
gerechtvaardigt	gerechtvaardigd
gerecruteerde	gerekruteerde
gerecruteerd	gerekruteerd
gerecyclet	gerecycled
geredeneert	geredeneerd
geredt	gered
gereduceert	gereduceerd
gereedt	gereed
gereet	gereed
gerefereert	gerefereerd
gereflecteert	gereflecteerd
gereformeert	gereformeerd
geregeerdt	geregeerd
geregeert	geregeerd
geregeldt	geregeld
geregelt	geregeld
geregent	geregend
geregisseert	geregisseerd
geregistreerdt	geregistreerd
geregistreert	geregistreerd
gereguleert	gereguleerd
gereinigdt	gereinigd
gereinigt	gereinigd
gereïntegreerd	gere-integreerd
gereist	gereisd
gerekendt	gerekend
gerekent	gerekend
gerelateert	gerelateerd
gereleased	gereleaset
geremt	geremd
gerenoveert	gerenoveerd
gerepareert	gerepareerd
gereserveert	gereserveerd
geresolveert	geresolveerd
gerespecteert	gerespecteerd
gerestaureert	gerestaureerd
geresulteert	geresulteerd
geret	gered
geretourneerdt	geretourneerd
geretourneert	geretourneerd
gereviseert	gereviseerd
geringt	geringd
germain	Germain
German	Duits
geroddelt	geroddeld
gerodeerdt	gerodeerd
geroeit	geroeid
geroemt	geroemd
geroert	geroerd
gerolt	gerold
gerommelt	gerommeld
gerooft	geroofd
gerooit	gerooid
gerookd	gerookt
geroostert	geroosterd
geruilt	geruild
geruimdt	geruimd
geruimt	geruimd
geruïneerdt	geruïneerd
gerunt	gerund
gerusdt	gerust
gerustgesteldt	gerustgesteld
gesaneerdt	gesaneerd
gescant	gescand
geschaadt	geschaad
geschaaft	geschaafd
geschaardt	geschaard
geschaart	geschaard
geschaat	geschaad
geschad	geschat
geschakelt	geschakeld
gescheelt	gescheeld
gescheldt	gescheld
gescheurt	gescheurd
geschikd	geschikt
geschildert	geschilderd
geschilt	geschild
geschoeidt	geschoeid
geschoolt	geschoold
geschordt	geschort
geschorsd	geschorst
geschreeuwt	geschreeuwd
geschreidt	geschreid
geschrobt	geschrobd
geschroeft	geschroefd
geschuurt	geschuurd
gescoort	gescoord
gescrubt	gescrubd
geselecteerdt	geselecteerd
geselecteert	geselecteerd
geserveert	geserveerd
geshowt	geshowd
gesiert	gesierd
gesignaleert	gesignaleerd
gesitueert	gesitueerd
gesjeest	gesjeesd
gesjoemelt	gesjoemeld
gesjouwdt	gesjouwd
geskiet	geskied
geslaagdt	geslaagd
geslaagt	geslaagd
gesleepd	gesleept
gesleurt	gesleurd
gesleutelt	gesleuteld
geslingert	geslingerd
gesloopd	gesloopt
gesmeedt	gesmeed
gesmeerdt	gesmeerd
gesmeert	gesmeerd
gesmeet	gesmeed
gesmokkelt	gesmokkeld
gesmoort	gesmoord
gesmult	gesmuld
gesneeuwt	gesneeuwd
gesneuvelt	gesneuveld
gesnipperdt	gesnipperd
gesnippert	gesnipperd
gesnoeit	gesnoeid
gesodemieterdt	gesodemieterd
gesoldeerdt	gesoldeerd
gesoldeert	gesoldeerd
gesorteert	gesorteerd
gespaardt	gespaard
gespaart	gespaard
gesparen	besparen
gespecialiseerdt	gespecialiseerd
gespecialiseert	gespecialiseerd
gespecificeert	gespecificeerd
gespeculeert	gespeculeerd
gespeeldt	gespeeld
gespeelt	gespeeld
gespeent	gespeend
gespeldt	gespeld
gespelt	gespeld
gespendeert	gespendeerd
gesperdt	gesperd
gespijkert	gespijkerd
gespod	gespot
gespoelt	gespoeld
gesponsort	gesponsord
gespreidt	gespreid
gespreit	gespreid
gesproeit	gesproeid
gespuugt	gespuugd
gestaaft	gestaafd
gestabiliseert	gestabiliseerd
gestadt	gestat
gestaldt	gestald
gestalt	gestald
gestansd	gestanst
gestapelt	gestapeld
gestard	gestart
gesteldt	gesteld
gestelt	gesteld
gestemdt	gestemd
gestempelt	gestempeld
gestemt	gestemd
gesteriliseert	gesteriliseerd
gesteunt	gesteund
gestilt	gestild
gestimuleert	gestimuleerd
gestoelt	gestoeld
gestoffeert	gestoffeerd
gestofzuigt	gestofzuigd
gestolt	gestold
gestooft	gestoofd
gestoomt	gestoomd
gestoordt	gestoord
gestoort	gestoord
gestopd	gestopt
gestord	gestort
gestormt	gestormd
gestrafd	gestraft
gestrandt	gestrand
gestrant	gestrand
gestreeft	gestreefd
gestreepd	gestreept
gestremt	gestremd
gestresd	gestrest
gestrompeldt	gestrompeld
gestrooidt	gestrooid
gestrooit	gestrooid
gestroomlijnt	gestroomlijnd
gestroomt	gestroomd
gestucd	gestuct
gestudeert	gestudeerd
gestuurdt	gestuurd
gestuurt	gestuurd
gestyleerde	gestileerde
gesubsidieerdt	gesubsidieerd
gesubsidieert	gesubsidieerd
gesuggereerdt	gesuggereerd
gesuggereert	gesuggereerd
gesukkelt	gesukkeld
gesynchroniseert	gesynchroniseerd
getagt	getagd
getaped	getapet
getaxeert	getaxeerd
geteelt	geteeld
geteistert	geteisterd
getekendt	getekend
getekent	getekend
geteldt	geteld
getelt	geteld
getempert	getemperd
getildt	getild
getilt	getild
getimmert	getimmerd
getind	getint
getitelt	getiteld
getoetsd	getoetst
getolereerdt	getolereerd
getolereert	getolereerd
getooit	getooid
getoondt	getoond
getoont	getoond
getornt	getornd
getovert	getoverd
getraindt	getraind
getraint	getraind
getrakteert	getrakteerd
getransformeert	getransformeerd
getransporteert	getransporteerd
getrapd	getrapt
getreurt	getreurd
getriggert	getriggerd
getrimt	getrimd
getroosd	getroost
getrouwt	getrouwd
getuigeverklaringen	getuigenverklaringen
getwijfelt	getwijfeld
getwittert	getwitterd
getypd	getypt
getypeert	getypeerd
geuid	geuit
geüpdated	geüpdatet
geupgraded	geüpgraded
geüploadt	geüpload
gevaccineert	gevaccineerd
gevalideert	gevalideerd
gevarieert	gevarieerd
gevechtshelicopters	gevechtshelikopters
gevedt	gevet
geveegt	geveegd
geveer	gever
geveilt	geveild
geveldt	geveld
gevelt	geveld
geventileert	geventileerd
geverfdt	geverfd
geverft	geverfd
gevergt	gevergd
gevestigdt	gevestigd
gevestigt	gevestigd
gevibreerdt	gevibreerd
gevierdt	gevierd
geviert	gevierd
gevingert	gevingerd
gevisd	gevist
gevloeit	gevloeid
gevoedt	gevoed
gevoegdt	gevoegd
gevoegt	gevoegd
gevoerdt	gevoerd
gevoert	gevoerd
gevoetbalt	gevoetbald
gevoet	gevoed
gevoldt	gevold
gevolgdt	gevolgd
gevolgende	gevolgen
gevol	gevolg
gevolgt	gevolgd
gevonnisd	gevonnist
gevordert	gevorderd
gevormdt	gevormd
gevormt	gevormd
gevraagdt	gevraagd
gevraagt	gevraagd
gevreest	gevreesd
gevuldt	gevuld
gevult	gevuld
gewaadt	gewaad
gewaait	gewaaid
gewaarborgt	gewaarborgd
gewaardeerdt	gewaardeerd
gewaardeert	gewaardeerd
gewaarschuwt	gewaarschuwd
gewaat	gewaad
gewandeldt	gewandeld
gewandelt	gewandeld
gewapent	gewapend
geweert	geweerd
geweesd	geweest
geweesdt	geweest
geweidt	geweid
geweigerdt	geweigerd
geweigert	geweigerd
gewekd	gewekt
geweldt	geweld
gewelt	geweld
gewensd	gewenst
gewerkd	gewerkt
gewichtdeel	gewichtsdeel
gewichtdelen	gewichtsdelen
gewiedt	gewied
gewiidt	gewiid
gewijdt	gewijd
gewijt	gewijd
gewijzigt	gewijzigd
gewikkeldt	gewikkeld
gewikkelt	gewikkeld
gewildt	gewild
gewilt	gewild
gewinkelt	gewinkeld
gewisselt	gewisseld
gewoedt	gewoed
gewondt	gewond
gewont	gewond
gewoondt	gewoond
gewoont	gewoond
geworstelt	geworsteld
gewortelt	geworteld
gewroedt	gewroet
gewurgt	gewurgd
gezaagt	gezaagd
gezaaidt	gezaaid
gezaait	gezaaid
gezakd	gezakt
gezed	gezet
gezedt	gezet
gezeeft	gezeefd
gezegdt	gezegd
gezegent	gezegend
gezegt	gezegd
gezeilt	gezeild
gezèt	gézet
gezeurt	gezeurd
gezichd	gezicht
geziende	geziene
geziend	gezien
gezindt	gezind
gezint	gezind
gezochd	gezocht
gezoent	gezoend
gezondigt	gezondigd
gezondsheidszorg	gezondheidszorg
gezondt	gezond
gezont	gezond
gezorgdt	gezorgd
gezorgt	gezorgd
gezuivert	gezuiverd
gezwaait	gezwaaid
gies	Gies
Giessendam/Neder-Hardinxveld	Giessendam - Neder-Hardinxveld
gillette	Gillette
ginnengappen	ginnegappen
github	GitHub
Github	GitHub
Gitlab	GitLab
glansende	glanzende
glansend	glanzend
glaske	glaasje
glazende	glanzende
glazend	glanzend
gl'ers	GL'ers
GL-ers	GL'ers
gl-fractie	GL-fractie
glooiiende	glooiende
glooingen	glooiingen
glooing	glooiing
Gnuplot	gnuplot
goedenmiddag	goedemiddag
goedertierende	goedertierene
goedertierend	goedertieren
goedgekeurdt	goedgekeurd
goedgekeurt	goedgekeurd
goedrecht	goed recht
goe	goed
goeieavondn	goeieavond
goeien	goeden
goeienmiddag	goeiemiddag
goei	goed
Golf van Kiparissia	Golf van Kyparissia
googelaar	goochelaar
gooi-en-smijt-film	gooi-en-smijtfilm
gooi-en-smijt-films	gooi-en-smijtfilms
gooi-en-smijt-werk	gooi-en-smijtwerk
Gooooooogle	Google
goudse	Goudse
gouds	Gouds
grabbelpas	Grabbelpas
graffitti	graffiti
grafgiftes	grafgiften
grafiti	graffiti
grafitti	graffiti
graspop	Graspop
grensen	grenzen
grenslogie	grenslogies
groend	groen
GroenLinks-lid	GroenLinkslid
groepsaccomodatie	groepsaccommodatie
grondstewardes	grondstewardess
Groot-Britannië	Groot-Brittannië
Guatemala-stad	Guatemala-Stad
H2O	H₂O
H²O	H₂O
haarlem	Haarlem
haasje-repje	haastje-repje
haatliefdeverhoudingen	haat-liefdeverhoudingen
haatliefdeverhouding	haat-liefdeverhouding
Hadewych	Hadewijch
haemorrhagie	hemorragie
hagels	hagel
hakkies	hakjes
halal vlees	halalvlees
half twaalf	halftwaalf
Hallooooo	Halló
halloween	Halloween
halucineer	hallucineer
halucineert	hallucineert
halucinerend	hallucinerend
halucineren	hallucineren
hamertje tik	hamertje-tik
handelsbarrie`res	handelsbarrière
handenspandiensten	hand-en-spandiensten
handlen	handelen
handliggende	hand liggende
hanne	Hanne
hanneman	Hanneman
hanzestad	Hanzestad
hapnotherapeuten	haptotherapeuten
hapnotherapeut	haptotherapeut
happie	gelukkig
happier	gelukkiger
harmoniecorps	harmoniekorps
has	had
hat	het
Hawaiaanse	Hawaïaanse
Hawaiaans	Hawaïaans
Hawai	Hawaï
Hawaiian	Hawaïaan
Hawaiians	Hawaïanen
hèbben	hébben
heeeeeeele	héle
heeeeeeel	héél
Heeeeeeel	Héél
heeeeeeerlijk	héérlijk
heeeeeele	héle
heeeeeel	héél
Heeeeeel	Héél
heeeeeerlijk	héérlijk
hèèl	héél
heengeleidt	heengeleid
heengetild	heen getild
heffingslokaties	heffingslocaties
he`	hè
heid	hei
heiligheit	heiligheid
helemaaaaaal	helemáál
helemal	helemaal
helem	hele
helicopter	helikopter
helicopters	helikopters
helicoptertje	helikoptertje
helicoptervlucht	helikoptervlucht
hellingske	hellinkje
helloweenfeest	halloweenfeest
helloween	Halloween
Helloween	Halloween
hèm	hém
hemmetjes	hemdjes
hep	heb
heppie	heb je
hept	helpt
hercalibratie	herkalibratie
Hergé's	Hergés
herkapitaliseerd	geherkapitaliseerd
herkenen	herkennen
heruitgaves	heruitgaven
herz	hertz
hesseling	Hesseling
he`t	hét
hetzelf	het zelf
hiér	híér
híer	híér
Híer	Híér
hightea-etagère	highteaetagère
hi hi	hihi
hindoees	hindoes
hindoe-nationalisten	hindoenationalisten
hinkstapspringen	hink-stap-springen
hinkstapsprong	hink-stap-sprong
hip-hop-cultuur	hiphopcultuur
hip-hopcultuur	hiphopcultuur
hippie-achtige	hippieachtige
hippie-achtig	hippieachtig
hirs	Hirs
hitlergroet	Hitlergroet
Hitler-groet	Hitlergroet
Hitler's	Hitlers
hm2	hm²
hobbies	hobby's
hobby`s	hobby's
hóe	hóé
hòe	hóé
hoekske	hoekje
hoeligan	hooligan
hoeligans	hooligans
hóeven	hóéven
hoevraag	hoe-vraag
hoevragen	hoe-vragen
hoffmann	Hoffmann
hofland	Hofland
hoge-snelheidstreinen	hogesnelheidstreinen
hoge-snelheidstrein	hogesnelheidstrein
holebijongeren	holebi-jongeren
homohuwlijk	homohuwelijk
homo`s	homo's
hoofdoekjes	hoofddoekjes
Hoogvlakte van Nieuw-Kastilië	Hoogvlakte van Nieuw-Castilië
Hoogvlakte van Oud-Kastilië	Hoogvlakte van Oud-Castilië
hotelrestaurant	hotel-restaurant
houdswerkzaamheden	onderhoudswerkzaamheden
houmous	hummus
housde	housede
howdo	houdoe
huib	Huib
huiske	huisje
hulpvragend	hulp vragend
hulzebos	Hulzebos
hùn	hún
huursubsidieuitgaven	huursubsidie-uitgaven
huuske	huisje
huwlijken	huwelijken
huwlijk	huwelijk
hybride-aandrijving	hybrideaandrijving
hybride-auto	hybrideauto
hybride-auto's	hybrideauto's
hyperuricaemie	hyperurikemie
hypoglycaemie	hypoglycemie
IBB laan	IBB-laan
IBBlaan	IBB-laan
IB`er	IB'er
ict-activiteiten	ICT-activiteiten
ict-afdeling	ICT-afdeling
ict-apparatuur	ICT-apparatuur
ict-basisvaardigheden	ICT-basisvaardigheden
ict-bedrijf	ICT-bedrijf
ict-bedrijven	ICT-bedrijven
ict-beheerders	ICT-beheerders
ict-beleid	ICT-beleid
ict-beleidsplan	ICT-beleidsplan
ict-budget	ICT-budget
ict-budgetten	ICT-budgetten
ict-coaches	ICT-coaches
ict-coach	ICT-coach
ict-competenties	ICT-competenties
ict-component	ICT-component
ict-coördinator	ICT-coördinator
ict-er	ICT'er
ICT-er	ICT'er
ict-ers	ICT'ers
ICT-ers	ICT'ers
ict-gebied	ICT-gebied
ict	ICT
ict-infrastructuur	ICT-infrastructuur
ict_integratie	ICT-integratie
ict-problemen	ICT-problemen
ict-producten	ICT-producten
ict-projecten	ICT-projecten
ict-project	ICT-project
ict-scholing	ICT-scholing
ict-sector	ICT-sector
ict-specialisten	ICT-specialisten
ict-systeem	ICT-systeem
ict-systemen	ICT-systemen
ict-toepassingen	ICT-toepassingen
ict-toepassing	ICT-toepassing
ict-vaardigheden	ICT-vaardigheden
ict-vaardigheid	ICT-vaardigheid
ict-vacatures	ICT-vacatures
ict-vergoeding	ICT-vergoeding
ict-voorzieningen	ICT-voorzieningen
ict-werkplekken	ICT-werkplekken
id-bewijs	ID-bewijs
identifceren	identificeren
idiologie	ideologie
idols	Idols
iemamd	iemand
íemand	íémand
íets	íéts
ietskes	ietsjes
Ijanuari	januari
Ijben	IJben
IJbergen	Eibergen
Ijbergen	IJbergen
Ijburg	IJburg
Ijdele	IJdele
Ijdelheid	IJdelheid
Ijdel	IJdel
Ijff	IJff
Ij	IJ
Ijkema	IJkema
Ijlst	IJlst
Ijmuiden	IJmuiden
Ijpelaar	IJpelaar
Ijsbaan	IJsbaan
Ijsberen	IJsberen
Ijsboereke	IJsboerke
Ijsbrand	IJsbrand
Ijse	IJse
Ijsetrippers	IJsetrippers
Ijshockey	IJshockey
Ijs	IJs
Ijskoude	IJskoude
Ijskoud	IJskoud
Ijslander	IJslander
Ijslanders	IJslanders
Ijsland	IJsland
Ijslandse	IJslandse
Ijslands	IJslands
Ijssel	IJssel
Ijsselmeer	IJsselmeer
Ijsselmonde	IJsselmonde
Ijsselmuiden	IJsselmuiden
Ijsselstein	IJsselstein
IJsselstijn	IJsselstein
Ijstijd	IJstijd
Ijsvogel	IJsvogel
Ijtsma	IJtsma
Ijverig	IJverig
Ijzelenberg	IJzelenberg
Ijzendijke	IJzendijke
Ijzerbedevaart	IJzerbedevaart
Ijzeren	IJzeren
Ijzerenleen	IJzerenleen
Ijzer	IJzer
Ijzerkotmolen	IJzerkotmolen
Ijzerman	IJzerman
Ijzermans	IJzermans
Ijzersterke	IJzersterke
Ijzersterk	IJzersterk
Ijzerstraat	IJzerstraat
Ijzertoren	IJzertoren
Ijzerwake	IJzerwake
ikheid	ik-heid
ìk	ík
inbde	in de
inbrekert	inbreker
inburgerings	inburgerings-
incassobureau's	incassobureaus
incassoburo	incassobureau
incassoburo's	incassobureaus
inderdaat	inderdaad
indiend	indient
Indiers	Indiërs
inflectie	inflexie
inflecties	inflexies
informatie-asymmetrie	informatieasymmetrie
informatieuitvraag	informatie-uitvraag
informatieuitwisselingen	informatie-uitwisselingen
informatieuitwisseling	informatie-uitwisseling
Informatieuitwisseling	Informatie-uitwisseling
informatieuitwisselingsverdrag	informatie-uitwisselingsverdrag
ingangdatum	ingangsdatum
ingeademt	ingeademd
ingebedt	ingebed
ingebet	ingebed
ingeboed	ingeboet
ingebouwdt	ingebouwd
ingebouwt	ingebouwd
ingebrandt	ingebrand
ingebreidt	ingebreid
ingeburgert	ingeburgerd
ingecalculeerdt	ingecalculeerd
ingedeeldt	ingedeeld
ingedeelt	ingedeeld
ingediendt	ingediend
ingedient	ingediend
ingeënd	ingeënt
ingegooidt	ingegooid
ingegooit	ingegooid
ingehaalt	ingehaald
ingehuurt	ingehuurd
ingekleedt	ingekleed
ingeklemt	ingeklemd
ingekleurt	ingekleurd
ingekwartiert	ingekwartierd
ingelegt	ingelegd
ingelevert	ingeleverd
ingelijft	ingelijfd
ingelogt	ingelogd
ingeluidt	ingeluid
ingeluist	ingeluisd
ingenieursbureau's	ingenieursbureaus
ingenieurscorps	ingenieurskorps
ingeruilt	ingeruild
ingescant	ingescand
ingeschakeldt	ingeschakeld
ingeschakelt	ingeschakeld
ingesmeert	ingesmeerd
ingespeelt	ingespeeld
ingesteldt	ingesteld
ingestelt	ingesteld
ingestemt	ingestemd
ingestord	ingestort
ingestudeert	ingestudeerd
ingestuurt	ingestuurd
ingetaped	ingetapet
ingetekent	ingetekend
ingevoegt	ingevoegd
ingevoerdt	ingevoerd
ingevoert	ingevoerd
ingevordert	ingevorderd
ingevuldt	ingevuld
ingevult	ingevuld
ingewijdt	ingewijd
ingewikkelt	ingewikkeld
ingewilligt	ingewilligd
ingezaait	ingezaaid
ingezamelt	ingezameld
ingezoomt	ingezoomd
inhaalmanoevre	inhaalmanoeuvre
inhaalmanouvre	inhaalmanoeuvre
ìn	ín
inkomensniveau's	inkomensniveaus
inkoppert	inkopper
insekticiden	insecticiden
Instragram	Instagram
integratieuitkering	integratie-uitkering
intercalibratie	interkalibratie
interimdividend	interim-dividend
interimperiode	interim-periode
interimregering	interim-regering
internetcafé's	internetcafés
internet-troll	internettrol
interveniëerde	intervenieerde
intestate	intestaat
intra-reproduceerbaarheids-variatiecoëfficiënt	intrareproduceerbaarheidsvariatiecoëfficiënt
investeringbeleid	investeringsbeleid
invrijheidsstellingen	invrijheidstellingen
invrijheidsstelling	invrijheidstelling
in zake	inzake
iPhone-bezitters	iPhonebezitters
iPhone-gebruikers	iPhonegebruikers
ipv	i.p.v.
isbn	ISBN
ISBN-nr.	ISBN
ìs	ís
iso-lijnen	isolijnen
issie	is hij
it	IT
ivm	i.v.m.
Jaaaaaaa	Já
jaaaaaaaren	járen
jaaaaaa	já
Jaaaaaa	Já
jaaaaaaren	járen
jaarlijk	jaarlijks
jaarstermijn	jaartermijn
ja`	já
ja-knikker	jaknikker
ja-knikkers	jaknikkers
jaknikkert	jaknikker
jane	Jane
jans	Jans
Jan's	Jans
Jantje van Leiden	jantje-van-leiden
Jantje-van-Leiden	jantje-van-leiden
ja-woord	jawoord
jeetje mina	jeetjemina
jeetjes	jeetje
Jehovagetuige	Jehova's getuige
Jehovagetuigen	Jehova's getuigen
jeremiëerde	jeremieerde
jerimieerde	jeremieerde
Jesusgebed	Jezusgebed
Jesus	Jezus
jetskiërt	jetskiër
jetten	jetskiën
jeu-de-boule	jeu-de-boul
jeu-de-boulert	jeu-de-boulesspeler
jeu-de-boules	jeu de boules
jeugdlogie	jeugdlogies
Jezuïten	Jezuïeten
Jezus`	Jezus'
jodenhaat	Jodenhaat
jodenjacht	Jodenjacht
Joeri van Gelder	Yuri van Gelder
johnny	Johnny
jongentje	jongetje
jongentjes	jongetjes
jop	JOP
joppe	Joppe
José's	Josés
judoen	judoën
judoka`s	judoka's
juigen	juichen
juig	juich
júist	júíst
julie	Julie
jurrie	Jurrie
justitieelmedisch	justitieel-medisch
kadobon	cadeaubon
kadobonnen	cadeaubonnen
kado	cadeau
kadoo	cadeau
kadoos	cadeaus
kadootje	cadeautje
kadootjes	cadeautjes
kadopapier	cadeaupapier
kado's	cadeaus
kados	cadeaus
kadotje	cadeautje
kadotjes	cadeautjes
kakske	kakje
kalashnikovs	kalasjnikovs
kalfzwezeriken	kalfszwezeriken
kalfzwezerik	kalfszwezerik
kamerdebat	Kamerdebat
kamerlid	Kamerlid
kamerlidmaatschap	Kamerlidmaatschap
kamermeerderheden	Kamermeerderheden
kamermeerderheid	Kamermeerderheid
kanaalzwemmert	Kanaalzwemmer
kandidaatlidstaten	kandidaat-lidstaten
kangaroe	kangoeroe
kangaroes	kangoeroes
kangaroo	kangoeroe
kangaroos	kangoeroes
kangoo	Kangoo
ka`n	kán
kantinekommissie	kantinecommissie
kaptein	kapitein
karaker	karakter
karameliseer	karamelliseer
karameliseert	karamelliseert
karameliseren	karamelliseren
karater	karakter
kaske	kastje
kastesysteem	kastensysteem
Kastiliaan	Castiliaan
Kastiliaans	Castiliaans
Kastiliaans Scheidingsgebergte	Castiliaans Scheidingsgebergte
Kastilië	Castilië
katastrofaal	catastrofaal
katastrofale	catastrofale
katastrofe	catastrofe
katastrophe	catastrofe
kawa	Kawa
kayaks	kajaks
kayaktocht	kajaktocht
kèn	kén
kènt	ként
kerkske	kerkje
kerstkado	kerstcadeau
kerstkadootje	kerstcadeautje
kerstkadootjes	kerstcadeautjes
kerver	Kerver
keuning	koning
kg/m3	kg/m³
kho	KHO
kiend	kind
kiet	quitte
kiezerd	kiezer
kiezerscorps	kiezerskorps
kijkert	kijker
kiloos	kilo's
kilo`s	kilo's
kippie	kipje
kitesurfert	kitesurfer
klaargestoomt	klaargestoomd
klassebehoud	klassenbehoud
klassebewustzijn	klassenbewustzijn
klassebureau	klassenbureau
klassediagram	klassendiagram
klassediagrammen	klassendiagram
klassefoto	klassenfoto
klassejustitie	klassenjustitie
klassepatiënten	klassenpatiënten
klasses	klassen
klassesolidariteit	klassensolidariteit
klassestrijd	klassenstrijd
klasseverschil	klassenverschil
Klassiekarabische	klassiek Arabische
Klassiekarabisch	klassiek Arabisch
kledingsstukken	kledingstukken
kledingsstuk	kledingstuk
kleinsaf	kleins af
klippel	Klippel
klup	club
klupje	clubje
kluppie	clubje
km2	km²
knijn	konijn
kno artsen	kno-artsen
kno arts	kno-arts
knoppie	knopje
koeieuier	koeienuier
koeieuiers	koeienuiers
koekske	koekje
koekskes	koekjes
koeltoer	cultuur
koerske	koersje
koerswijzingen	koerswijzigingen
kokschool	koksschool
kokus	kokos
komfort	comfort
kommies	commissaris
kommisje	commissie
kommissaris	commissaris
kommissie	commissie
kommissies	commissies
kompleet	compleet
komputer	computer
komputerprogramma	computerprogramma
komputerprogramma's	computerprogramma's
komputers	computers
kongsies	kongsi's
koninggin	koningin
koninginnedagen	Koninginnedagen
koninginnedag	Koninginnedag
Koninginnenach	koninginnenacht
Koninginnendag	Koninginnedag
koninginnesoep	koninginnensoep
Koningrijk	Koninkrijk
koningsdag	Koningsdag
kòn	kón
konstatering	constatering
kontent	content
kopiëerde	kopieerde
koppe	koppen
koppie	kop
koppies	koppen
koptelefonen	koptelefoons
koranscholen	Koranscholen
Koror	Melekeok
Kòrsou	Curaçao
kort-geding	kortgeding
kort-gedingprocedure	kortgedingprocedure
kort-gedingrechter	kortgedingrechter
kostenloos	kosteloos
kostenverslindende	geldverslindende
kostenverslindend	geldverslindend
koterie	coterie
kraamkado	kraamcadeau
kreatief	creatief
kreatieve	creatieve
kreditkaartverwerker	creditkaartverwerker
krobya	krobiya
kruiske	kruisje
kruizenmunt	kruizemunt
krullebol	krullenbol
kukelekuën	kukelekuen
kùnnen	kúnnen
kunstenaren	kunstenaars
kvv-er	kvv'er
kvv-ers	kvv'ers
kwaliteitsniveau's	kwaliteitsniveaus
kwerulant	querulant
kwispendoor	kwispedoor
labyrinthen	labyrinten
labyrinth	labyrint
lage-lonenlanden	lagelonenlanden
landschapformaat	landschapsformaat
lange-afstandsraketten	langeafstandsraketten
lange-afstandsverbindingen	langeafstandsverbindingen
langparkeren	lang parkeren
lappie	lapje
laptoppie	laptopje
lawinen	lawines
Lazio`s	Lazio's
leasie	laesie
leasies	laesies
LEDjes	ledjes
leeggerooft	leeggeroofd
leerkrachtencorps	leerkrachtenkorps
leerlingverpleegkundigen	leerling-verpleegkundigen
leerwerktraject	leer-werktraject
leiddraad	leidraad
lekkerbekkies	lekkerbekjes
lendedoek	lendendoek
lensen	lenzen
lente-achtig	lenteachtig
lenteuitjes	lente-uitjes
lerarencorps	lerarenkorps
lesie	laesie
lesies	laesies
lesverstoren	les verstoren
letergreep	lettergreep
letstel	letsel
leveloos	levenloos
levenbeschouwelijke	levensbeschouwelijke
levencyclus	levenscyclus
Levencyclus	Levenscyclus
levensbeeindiging	levensbeëindiging
leverd	levert
leverpatienten	leverpatiënten
leverpatient	leverpatiënt
LGBT-gemeenschap	lgbt-gemeenschap
licenti	licentie
lichtgolvende	licht golvende
lidteken	litteken
lidtekens	littekens
lidtekenweefsel	littekenweefsel
lidtekenweefsels	littekenweefsels
liëerde	lieerde
liefdespoezie	liefdespoëzie
Liège	Luik
lievende	levende
lievend	levend
limericken	limericks
liniaire	lineaire
liniair	lineair
linksrijden	links rijden
lipitor	Lipitor
l-kamer	L-kamer
lk	ik
Lleinpolderplein	Kleinpolderplein
lobbies	lobby's
locale	lokale
loco-burgemeester	locoburgemeester
loco-burgemeesters	locoburgemeesters
logeerdert	logee
logementsschepen	logementschepen
logementsschip	logementschip
logé's	logés
lokatiebeleid	locatiebeleid
lokatiebepaling	locatiebepaling
lokatief	locatief
lokatiegebonden	locatiegebonden
lokatiekeuze	locatiekeuze
lokatie	locatie
Lokatie	Locatie
lokatieniveau	locatieniveau
lokaties	locaties
Lokaties	Locaties
lokatiespecifieke	locatiespecifieke
lokomotief	locomotief
lollytje	lolly'tje
London	Londen
loor	teloor
losgebrandt	losgebrand
losgekoppelt	losgekoppeld
losgeschudt	losgeschud
lounge-achtige	loungeachtige
Lou's	Lous
lovert	lover
ls	is
luiaarden	luiaards
lumineux	lumineus
luske	lusje
luxueuse	luxueuze
m2	m²
m₂	m²
m3	m³
m₃	m³
maaaaaaar	máár
maaaaaanden	máánden
maaaaaar	máár
Maaaaaar	Máár
maandelijke	maandelijkse
maasvlakte	Maasvlakte
machtspelletjes	machtsspelletjes
mac	Mac
madonnabeelden	Madonnabeelden
mafia-achtige	maffia-achtige
magazine-achtige	magazineachtige
maggie	mag hij
mailingen	mailings
maisje	meisje
maïslabyrinth	maïslabyrint
maisonette	maisonnette
maisonettes	maisonnettes
maitresse	maîtresse
maitresses	maîtresses
malariaepidemieën	malaria-epidemieën
malle praat	mallepraat
mama`s	mama's
maneuvre	manoeuvre
maneuvreren	manoeuvreren
maneuvres	manoeuvres
manoevreerruimte	manoeuvreerruimte
manoevreert	manoeuvreert
manoevre	manoeuvre
manoevreren	manoeuvreren
manoevres	manoeuvres
manouvreerde	manoeuvreerde
manouvreerruimte	manoeuvreerruimte
manouvreert	manoeuvreert
manouvre	manoeuvre
manouvreren	manoeuvreren
manouvres	manoeuvres
maria	Maria
Maria-Theresia	Maria Theresa
marijuana	marihuana
Marijuana	Marihuana
marinierscorps	marinierskorps
marktvertrouw	marktvertrouwen
Marshallaan	Marshalllaan
masaal	massaal
maseuren	masseurs
maseurs	masseurs
maseurtje	masseurtje
masqué's	masqués
massauitsterving	massa-uitsterving
Matlab	MATLAB
matze	matse
MBO-er	mbo'er
MBO-ers	mbo'ers
MBO-opgeleide	Mbo-opgeleide
MBO-opgeleiden	Mbo-opgeleiden
MBO-raad	MBO Raad
MBO-Raad	MBO Raad
medegedeelt	medegedeeld
medemogelijk	mede mogelijk
mede-ondernemer	medeondernemer
mederwerkers	medewerkers
mediabureau's	mediabureaus
meegedeelt	meegedeeld
meegelevert	meegeleverd
meegereist	meegereisd
meegerekent	meegerekend
meegesleurt	meegesleurd
meegespeelt	meegespeeld
meegestuurt	meegestuurd
meegetelt	meegeteld
meerdermalen	meermalen
meermaal	meermaals
mèèr	méér
megainvesteringen	mega-investeringen
megainvestering	mega-investering
megalitische	megalithische
megalitisch	megalithisch
mel	Mel
membraam	membraan
membramen	membranen
menieën	meniën
meno	memo
menske	mensje
menskes	mensjes
merlijn	marlijn
mert	met
methet	met het
métier	metier
me`t	mét
metro-achtige	metroachtige
meu	mag
Mexico-stad	Mexico-Stad
middenrijk	Middenrijk
mien	mijn
miereneuker	mierenneuker
miereneukers	mierenneukers
mijard	miljard
mijoen	miljoen
milie	milieu
milieu-economische	milieueconomische
milieu-economisch	milieueconomisch
milieu-educatief	milieueducatief
milieu-en	milieus
milieuimpact	milieu-impact
milieuindicatoren	milieu-indicatoren
milieuinformatie	milieu-informatie
milieuinnovatie	milieu-innovatie
milieuinnovaties	milieu-innovaties
milieuinspectie	milieu-inspectie
Milieuinspectie	Milieu-inspectie
milieuinvesteringen	milieu-investeringen
milieu-opzicht	milieuopzicht
mil	miljoen
minder-draagkrachtige	minderdraagkrachtige
minder-validen	mindervaliden
minijurken	mini-jurken
minijurkje	mini-jurkje
minijurkjes	mini-jurkjes
minijurk	mini-jurk
ministerpresident	minister-president
mir	MIR
mise`re	misère
mit	met
MixCloud	Mixcloud
mkb-er	mkb'er
MKB'er	mkb'er
MKB-er	mkb'er
mkb-ers	mkb'ers
MKB'ers	mkb'ers
MKB-ers	mkb'ers
MKB-vrijstellingen	mkb-vrijstellingen
MKB-vrijstelling	mkb-vrijstelling
mm2	mm²
mm3	mm³
m`n	m'n
mn	m'n
M`n	M'n
moederdagkado	moederdagcadeau
moederdag	Moederdag
moederstaal	moedertaal
móest	móést
moéten	móéten
móeten	móéten
móet	móét
mòet	móét
mond-aan-mond-reclame	mond-tot-mondreclame
mond-aan-mondreclame	mond-tot-mondreclame
mondelijk	mondeling
mond-op-mond-beademing	mond-op-mondbeademing
mond-opmondbeademing	mond-op-mondbeademing
mond-op-mond-reclame	mond-tot-mondreclame
mond-op-mondreclame	mond-tot-mondreclame
mond-tot-mondbeademing	mond-op-mondbeademing
mond-tot-mond-reclame	mond-tot-mondreclame
mongeaul	mongool
monolitische	monolithische
monolitisch	monolithisch
monopolyert	monopolyspeler
monopolypositie	monopoliepositie
montessori	Montessori
Montessorri	Montessori
monumentendag	Open Monumentendag
moooooi	móói
morse-code	morsecode
moskeeen	moskeeën
moskeen	moskeeën
moskees	moskeeën
moskeet	moskee
moslem	moslim
moslems	moslims
moslim-fundamentalistische	moslimfundamentalistische
Moterola	Motorola
mri	MRI
m/s2	m/s²
murks	Murks
mutske	mutsje
muurbeschilderingen	muurschilderingen
muziekaal	muzikaal
muziekcorpsen	muziekkorpsen
muziekcorps	muziekkorps
MySpace	Myspace
Myspell	MySpell
naäpers	na-apers
naarbinnen	naar binnen
naarboven	naar boven
naarde	naar de
nachtmerrie-achtige	nachtmerrieachtige
nageleeft	nageleefd
nagelriempjess	nagelriempjes
nagestreeft	nagestreefd
nagevraagt	nagevraagd
naijlende	na-ijlende
naijlend	na-ijlend
najaars	najaars-
na`	ná
Natùùrlijk	Natúúrlijk
nawijn	Nawijn
nazi-achtige	naziachtige
Nederlands Antilliaan	Nederlands-Antilliaan
Nederlands Antilliaans	Nederlands-Antilliaans
nederlandstalige	Nederlandstalige
neeeeeee	néé
Neeeeeee	Néé
neeeeee	néé
Neeeeee	Néé
neergelegt	neergelegd
neergestord	neergestort
neestemmer	nee-stemmer
negentiend	negentiende
negerkes	zwartjes
négligé	negligé
NEN1006	NEN 1006
NEN1010	NEN 1010
NEN2575	NEN 2575
NEN3610	NEN 3610
NEN-5740	NEN 5740
NEN5740	NEN 5740
neude	Neude
nevenlokatiebeleid	nevenlocatiebeleid
New-Yorkse	New Yorkse
ng	nog
Nicolas Sarcozy	Nicolas Sarkozy
nicol	Nicole
nie	niet
niet-bijbelse	niet-Bijbelse
nie`t	níét
niét	níét
nìet	níét
nìets	níéts
nieuwbouwlokaties	nieuwbouwlocaties
Nieuw-Kastilië	Nieuw-Castilië
Nieuw Nickerie	Nieuw-Nickerie
nightclub	nachtclub
nikkert	zwarte
niobe	Niobe
niveau's	niveaus
nix	niks
nobelprijs-winnaar	Nobelprijswinnaar
nobelprijswinnaar	Nobelprijswinnaar
Nobelprijs-winnaar	Nobelprijswinnaar
nobelprijs-winnaars	Nobelprijswinnaars
nobelprijswinnaars	Nobelprijswinnaars
Nobelprijs-winnaars	Nobelprijswinnaars
nòch	nóch
no-fly-zone	no-flyzone
no-fly-zones	no-flyzones
nogmaal	nogmaals
nòg	nóg
Nòg	Nóg
noire	noir
noires	noirs
nonactief	non-actief
nononsense	no-nonsense
no-nonsens	no-nonsense
noodle	noedel
noodles	noedels
noodlesoep	noedelsoep
noodopvang-achtige	noodopvangachtige
noooooit	nóóit
nooooooit	nóóit
noooooooit	nóóit
NoordKorea	Zuid-Korea
noord-oostelijke	noordoostelijke
noord-westelijke	noordwestelijke
noord-zuid-as	noord-zuidas
noordzuid-as	noord-zuidas
noordzuid-assen	noord-zuidassen
noord-zuid-baan	noord-zuidbaan
noordzuid-baan	noord-zuidbaan
noordzuid-banen	noord-zuidbanen
noordzuid-lijnen	noord-zuidlijnen
noordzuid-lijn	noord-zuidlijn
noordzuidlijn	noord-zuidlijn
noord-zuid-richting	noord-zuidrichting
noordzuid-richting	noord-zuidrichting
noordzuid-route	noord-zuidroute
noordzuid-routes	noord-zuidroutes
noordzuid-verbindingen	noord-zuidverbindingen
noordzuid-verbinding	noord-zuidverbinding
noordzuidverbinding	noord-zuidverbinding
normaalgesproken	normaal gesproken
nù	nú
Nù	Nú
Nusta	Ñusta
n.v.d.r	n.v.d.r.
nvidia	NVIDIA
Nvidia	NVIDIA
o-benen	O-benen
oegen	ogen
oer-conservatief	oerconservatief
oer-conservatieve	oerconservatieve
oer-elementen	oerelementen
oer-hollandse	oer-Hollandse
oerhollandse	oer-Hollandse
oer-hollands	oer-Hollands
oerhollands	oer-Hollands
oer-oude	oeroude
off-topic	offtopic
òf	óf
oft	loft
òfwel	ófwel
ola	cola
olieindustrie	olie-industrie
oma`s	oma's
omd	om
omfloersd	omfloerst
omgebouwdt	omgebouwd
omgebouwt	omgebouwd
omgedoopd	omgedoopt
omgedraait	omgedraaid
omgegooit	omgegooid
omgekeerdt	omgekeerd
omgekeert	omgekeerd
omgekleedt	omgekleed
omgeleidt	omgeleid
omgerekent	omgerekend
omgetovert	omgetoverd
omgevormdt	omgevormd
omgevormt	omgevormd
omgewisselt	omgewisseld
òm	óm
onbesuiste	onbesuisde
onderde	onder de
onderdrukd	onderdrukt
ondergedompelt	ondergedompeld
ondermeningen	ondernemingen
ondernemeningen	ondernemingen
ondernemening	onderneming
ònder	ónder
onderstal	Onderstal
onderwij	onderwijs
Onderzoeklokatie	Onderzoekslocaties
onderzoeksbureau's	onderzoeksbureaus
onderzoeksburo	onderzoeksbureau
ongeloofelijk	ongelooflijk
ongelovelijk	ongelofelijk
ongever	ongeveer
ongezoute	ongezouten
onkangs	onlangs
online-stemhulpen	online stemhulpen
online-stemhulp	online stemhulp
onmiddelijke	onmiddellijke
onmiddelijk	onmiddellijk
òns	óns
ontaart	ontaard
ontblood	ontbloot
ontbloodt	ontbloot
ontdekd	ontdekt
ontdekdt	ontdekt
ontfangen	ontvangen
onthooft	onthoofd
ontmaagt	ontmaagd
ontmoed	ontmoet
ontmoedt	ontmoet
ontologiën	ontologieën
ontplofd	ontploft
ontplooiien	ontplooien
ontschot	ontschoot
ontwikkelingsamenwerking	ontwikkelingssamenwerking
ontwikkelingslokaties	ontwikkelingslocaties
onwelwillig	ongewillig
Onze Lieve Heer	Onze-Lieve-Heer
ònze	ónze
o`	ó
ooggetuigeverslag	ooggetuigenverslag
oogskes	oogjes
óok	óók
òòk	óók
oooooooh	óh
oorsponkelijk	oorspronkelijk
oo serieux	au sérieux
oo-serieux	au sérieux
oo sérieux	au sérieux
oo-sérieux	au sérieux
oostbloklanden	Oostbloklanden
oostenrijk	Oostenrijk
Oostfriese	Oost-Friese
Oost/Watergraafsmeer	Oost-Watergraafsmeer
oost-west-as	oost-westas
oost-west-baan	oost-westbaan
oost-west-richting	oost-westrichting
Oost-Zeeuws-Vlaanderen	Oost Zeeuws-Vlaanderen
opdrach	opdracht
opelkaar	op elkaar
openbaarvervoer	openbaar vervoer
opengescheurdt	opengescheurd
opengestelt	opengesteld
opensource	open source
opentaal	OpenTaal
openTaal	OpenTaal
op en top	op-en-top
opgaveformulieren	opgavenformulieren
opgaveformulier	opgavenformulier
opgaves	opgaven
opgaveverplichting	opgavenverplichting
opgebelt	opgebeld
opgebouwdt	opgebouwd
opgebouwt	opgebouwd
opgebrandt	opgebrand
opgedeeldt	opgedeeld
opgedeelt	opgedeeld
opgedient	opgediend
opgedroogdt	opgedroogd
opgedroogt	opgedroogd
opgeëisd	opgeëist
opgefrisd	opgefrist
opgegroeidt	opgegroeid
opgegroeit	opgegroeid
opgehaaldt	opgehaald
opgehaalt	opgehaald
opgeheldert	opgehelderd
opgehoogt	opgehoogd
opgejaagt	opgejaagd
opgeknapd	opgeknapt
opgekuisd	opgekuist
opgelaaidt	opgelaaid
opgeled	opgelet
opgelegt	opgelegd
opgeleidt	opgeleid
opgeleit	opgeleid
opgelevert	opgeleverd
opgelosd	opgelost
opgelosdt	opgelost
opgemaakd	opgemaakt
opgemerkd	opgemerkt
opgeoffert	opgeofferd
opgepikd	opgepikt
opgerolt	opgerold
opgeruimdt	opgeruimd
opgeruimt	opgeruimd
opgeschoont	opgeschoond
opgeschroeft	opgeschroefd
opgeschudt	opgeschud
opgeschut	opgeschud
opgesomt	opgesomd
opgespeldt	opgespeld
opgespoort	opgespoord
opgestapelt	opgestapeld
opgestard	opgestart
opgesteldt	opgesteld
opgestelt	opgesteld
opgestuurdt	opgestuurd
opgestuurt	opgestuurd
opgetekent	opgetekend
opgetelt	opgeteld
opgetilt	opgetild
opgetrommelt	opgetrommeld
opgetuigt	opgetuigd
opgevoedt	opgevoed
opgevoerdt	opgevoerd
opgevoert	opgevoerd
opgevoet	opgevoed
opgevolgt	opgevolgd
opgevraagt	opgevraagd
opgevult	opgevuld
opgewaardeert	opgewaardeerd
opgewarmt	opgewarmd
opgewekd	opgewekt
opgezadelt	opgezadeld
opgezed	opgezet
opgezegt	opgezegd
opleidings	opleidings-
opleidi	opleiding
opname's	opnames
opnieuwe	opnieuw
òp	óp
opschoningwerkzaamheden	opschoningswerkzaamheden
opvanglokaties	opvanglocaties
orchestrale	orkestrale
orchestratie	orkestratie
orchestreren	orkestreren
ordend	ordent
o-ringen	O-ringen
o-ring	O-ring
orleans	Orleans
oscarwinnaar	Oscarwinnaar
oudeman	oude man
oud-oom	oudoom
oud-ooms	oudooms
oud-testamentische	oudtestamentische
OV-aanbod	ov-aanbod
OV-abonnementen	ov-abonnementen
OV-abonnement	ov-abonnement
OV-alternatieven	ov-alternatieven
OV-autoriteiten	ov-autoriteiten
OV-autoriteit	ov-autoriteit
OV-bedrijf	ov-bedrijf
OV-bedrijven	ov-bedrijven
OV-beleid	ov-beleid
OV-bussen	ov-bussen
OV-capaciteit	ov-capaciteit
ov-capaticeit	ov-capaciteit
OV-chipcard	OV-chipkaart
OV-diensten	ov-diensten
overdijk	Overdijk
overgehaalt	overgehaald
overgehevelt	overgeheveld
overgelegt	overgelegd
overgelevert	overgeleverd
overgeschakelt	overgeschakeld
overgevloeidt	overgevloeid
overgewaait	overgewaaid
overheersd	overheerst
overheidsfinancien	overheidsfinanciën
overheidsniveau's	overheidsniveaus
overheidssubsidiering	overheidssubsidiëring
òver	óver
OV-exploitanten	ov-exploitanten
OV-exploitatie	ov-exploitatie
OV-Fiets	OV-fiets
OV-gebruikers	ov-gebruikers
OV-gebruik	ov-gebruik
OV-halte	ov-halte
OV-haltes	ov-haltes
OV-infrastructuur	ov-infrastructuur
OV-jaarabonnement	ov-jaarabonnement
OV-jaarkaarten	ov-jaarkaarten
OV-jaarkaarthouders	ov-jaarkaarthouders
OV-jaarkaart	ov-jaarkaart
OV-kaarten	ov-kaarten
OV-kaart	ov-kaart
OV-knooppunten	ov-knooppunten
OV-knooppunt	ov-knooppunt
paanakker	Paanakker
paardekastanje	paardenkastanje
paardekastanjes	paardenkastanjes
paddestoelen	paddenstoelen
paddestoelensaus	paddenstoelensaus
paddestoelensector	paddenstoelensector
paddestoelenteelt	paddenstoelenteelt
paddestoel	paddenstoel
paddestoeltje	paddenstoeltje
paddestoeltjes	paddenstoeltjes
paddestoelvormige	paddenstoelvormige
pagina`s	pagina's
pakkies	pakjes
pakskes	pakjes
Palauaans	Paulus
palestijnen	Palestijnen
palmzondag	Palmzondag
Paluees	Paulus
Panama-stad	Panama-Stad
paneuropees	pan-Europees
paneuropese	pan-Europese
pannekoekenhuis	pannenkoekenhuis
pannekoeken	pannenkoeken
pannekoekje	pannenkoekje
pannekoekjes	pannenkoekjes
pannekoek	pannenkoek
paralellen	parallellen
paralelle	parallelle
paralel	parallel
parallele	parallelle
para-medici	paramedici
para-medicus	paramedicus
para-medische	paramedische
para-medisch	paramedisch
para-militaire	paramilitaire
para-militair	paramilitair
paras	para's
paratbc	para-tbc
parauniversitaire	para-universitaire
parauniversitair	para-universitair
parijs	Parijs
Parmazaanse	Parmezaanse
parmezaanse	Parmezaanse
pasport	paspoort
passage's	passages
passagierschip	passagiersschip
passport	paspoort
passports	paspoorten
pastoren	pastoors
patiënce	patience
patientiewerken	patiëntiewerken
patientiewerk	patiëntiewerk
patientjes	patiëntjes
patientmateriaal	patiëntmateriaal
pati	patiënt
patisserieen	patisserieën
patjepeeer	patjepeeër
patjepeeers	patjepeeërs
patjepeër	patjepeeër
pdf-format	pdf-formaat
pdf-je	pdf'je
pdfje	pdf'je
PDF-je	pdf'je
pdfs	pdf's
PDF's	pdf's
penalties	penalty's
penalty`s	penalty's
pé	pee
periodeonderwjs	periodeonderwijs
persbureau's	persbureaus
perscorps	perskorps
persentage	percentage
personenauto`s	personenauto's
persoonsgebondenbudget	persoonsgebonden budget
pétanque	petanque
petanquert	petanquespeler
peterman	pieterman
PeterS	Peters
peuterzoont	peuterzoon
Phoeniciër	Feniciër
Phoeniciërs	Feniciërs
phoenix	feniks
phytophtora	phytophthora
Phytophtora	phytophthora
pie`ce	pièce
pie`ces	pièce
pietje precies	pietje-precies
pietjes precies	pietjes-precies
piezo-element	piëzo-element
piezoelement	piëzo-element
piëzoelement	piëzo-element
pikketanussie	pikketanissie
pilotlokaties	pilotlocaties
pilske	pilsje
piña	pina
pinguin	pinguïn
pinguins	pinguïns
pitoreske	pittoreske
pitoresk	pittoresk
pizzahut	Pizza Hut
plaatskes	plaatsjes
planbureau's	planbureaus
plannin	planning
plassert	plasser
plateau's	plateaus
platgebrandt	platgebrand
plekkies	plekjes
plekskes	plekjes
ploegske	ploegje
plugged	plugt
plugin	plug-in
plumeau's	plumeaus
poenale	penale
poene	straffe
poepert	poeper
poetische	poëtische
pole-positie	polepositie
pole-position	poleposition
pole-positions	polepositions
polisie	politie
politburo	politbureau
politiebureau's	politiebureaus
politieburo	politiebureau
politiecordon	politiekordon
politiecorpsen	politiekorpsen
politiecorps	politiekorps
politieen	politie en
politiehelicopter	politiehelikopter
politiehelicopters	politiehelikopters
politiek-correcten	politiek corrrecten
politiekcorrecte	politiek correcte
politiek-correct	politiek correct
politiekcorrect	politiek correct
politiek-incorrecte	politiek incorrecte
politiek-incorrect	politiek incorrect
polstokspringen	polsstokspringen
pony`s	pony's
popie-jopie	popiejopie
popijopie	popiejopie
poppie	popje
poppies	popjes
Poppies	Popjes
populatiegevens	populatiegegevens
porsche	Porsche
pors	Pors
portemonee	portemonnee
portomonee	portemonnee
portomonnee	portemonnee
potske	potje
pouw	pauw
Povray	POV-Ray
praatzaam	spraakzaam
practikanten	praktikanten
practikant	praktikant
practische	praktische
practischer	praktischer
practisch	praktisch
prakticanten	praktikanten
prakticant	praktikant
praktij	praktijk
praten als brugman	praten als Brugman
predikantencorps	predikantenkorps
preïndustriële	pre-industriële
premie`re	première
premieuitgaven	premie-uitgaven
presidentsschap	presidentschap
presies	precies
prestaiieafspraken	prestatieafspraken
prijske	prijsje
prijsniveau's	prijsniveaus
prijze	prijzen
prince	Prince
prinsgemaal	prins-gemaal
privé-audiëntie	privéaudiëntie
priv	privé
procesverbalen	processen-verbaal
pro deaan	pro-Deaan
pro-deaan	pro-Deaan
prodeaan	pro-Deaan
pro deanen	pro-Deanen
pro-deanen	pro-Deanen
prodeanen	pro-Deanen
pro-Dean	pro-Deaan
productieuitval	productie-uitval
proffesionals	professionals
proffessioneel	professioneel
programma`s	programma's
proppie	propje
protozoon	protozoön
providentiele	providentiële
provinciale staten	Provinciale Staten
provincieën	provinciën
provisoor	provisoir
provisore	provisoir
prozaisch	prozaïsch
prozaisten	prozaïsten
prozaist	prozaïst
pruderieen	pruderieën
pruimendant	pruimedant
pruimen-eau-de-vie	pruimeneau-de-vie
prularia	prullaria
przwalskypaard	przewalskipaard
psalmodieen	psalmodieën
psalmodieren	psalmodiëren
pseudointellectueel	pseudo-intellectueel
pseudointellectuele	pseudo-intellectuele
pseudo-weduwen	pseudoweduwen
pseudo-weduwe	pseudoweduwe
pseudo-wetenschappelijke	pseudowetenschappelijke
pseudo-wetenschappelijk	pseudowetenschappelijk
pseudo-wetenschappen	pseudowetenschappen
pseudo-wetenschapper	pseudowetenschapper
pseudo-wetenschappers	pseudowetenschappers
pseudo-wetenschap	pseudowetenschap
pseudo-wetgeving	pseudowetgeving
P.S.	PS
push-upbh	push-up-bh
push-upbh's	push-up-bh's
pvda'er	PvdA'er
pvda-er	PvdA'er
pvdaer	PvdA'er
Pvda'er	PvdA'er
PvdA-er	PvdA'er
PVDA-er	PVDA'er
PVDAer	PVDA'er
pvda-ers	PvdA'ers
pvdaers	PvdA'ers
Pvda'ers	PvdA'ers
PvdA-ers	PvdA'ers
PVDA-ers	PVDA'ers
PvdA-kamerlid	PvdA-Kamerlid
pvv'er	PVV'er
pvv-er	PVV'er
PVV-er	PVV'er
pvv'ers	PVV'ers
pvv-ers	PVV'ers
PVV-ers	PVV'ers
pyramiden	piramiden
pyramide	piramide
pyramidespel	piramidespel
pyramides	piramides
qualiteit	kwaliteit
quanta	kwanta
quantumfysica	kwantumfysica
quantum	kwantum
quantummechanica	kwantummechanica
quantummechanische	kwantummechanische
quantummechanisch	kwantummechanisch
quartz	kwarts
quasi-authentiek	quasiauthentiek
quasi-diepzinnige	quasidiepzinnige
quasi-nonchalant	quasinonchalant
quasi-wetenschappelijk	quasiwetenschappelijk
quat	qat
quatrocento	quattrocento
Queen-Annestijl	Queen Annestijl
Querido`s	Querido's
queries	query's
questen	queesten
queste	queeste
questie	kwestie
questionaire	questionnaire
quest	queeste
queueen	queueën
queuen	queueën
quiche loraine	quiche lorraine
quietisme	quiëtisme
Quijote	Quichot
quintessence	kwintessens
quintessens	kwintessens
quint	kwint
quite	quitte
quizen	quizzen
quiz master	quizmaster
quizzes	quizzen
quizz	quiz
quoka	quokka
quootje	quoteje
quotienten	quotiënten
quotient	quotiënt
qwerty-klavieren	qwertyklavieren
QWERTY-klavieren	qwertyklavieren
qwerty-klavier	qwertyklavier
QWERTY-klavier	qwertyklavier
qwerty-klaviertje	qwertyklaviertje
QWERTY-klaviertje	qwertyklaviertje
qwerty-klaviertjes	qwertyklaviertjes
QWERTY-klaviertjes	qwertyklaviertjes
qwerty-toetsenborden	qwertytoetsenborden
QWERTY-toetsenborden	qwertytoetsenborden
qwerty-toetsenbordje	qwertytoetsenbordje
QWERTY-toetsenbordje	qwertytoetsenbordje
qwerty-toetsenbordjes	qwertytoetsenbordjes
QWERTY-toetsenbordjes	qwertytoetsenbordjes
qwerty-toetsenbord	qwertytoetsenbord
QWERTY-toetsenbord	qwertytoetsenbord
qwertz-klavieren	qwertzklavieren
QWERTZ-klavieren	qwertzklavieren
qwertz-klavier	qwertzklavier
QWERTZ-klavier	qwertzklavier
qwertz-klaviertje	qwertzklaviertje
QWERTZ-klaviertje	qwertzklaviertje
qwertz-klaviertjes	qwertzklaviertjes
QWERTZ-klaviertjes	qwertzklaviertjes
qwertz-toetsenborden	qwertztoetsenborden
QWERTZ-toetsenborden	qwertztoetsenborden
qwertz-toetsenbordje	qwertztoetsenbordje
QWERTZ-toetsenbordje	qwertztoetsenbordje
qwertz-toetsenbordjes	qwertztoetsenbordjes
QWERTZ-toetsenbordjes	qwertztoetsenbordjes
qwertz-toetsenbord	qwertztoetsenbord
QWERTZ-toetsenbord	qwertztoetsenbord
raadsenquete	raadsenquête
radaartje	radartje
radiouitzendingen	radio-uitzendingen
railing	reling
rakija	rakia
Randstadrail	RandstadRail
ransige	ranzige
ransiger	ranziger
ransig	ranzig
ransigste	ranzigste
rapsen	raspen
reactie`s	reacties
readership	relatie
realiestieser	realistischer
real time	realtime
real-time	realtime
recherchebureau's	recherchebureaus
rechtercommissaris	rechter-commissaris
rechtergrafiek	rechter grafiek
rechtevenredig	recht evenredig
rechtoe	rechttoe
rechtsextremisme	rechts-extremisme
rechtsextremistische	rechts-extremistische
rechtsextremistisch	rechts-extremistisch
rechtsomkeerd	rechtsomkeert
rechtzaak	rechtszaak
rechtzitting	rechtszitting
reclamebureau's	reclamebureaus
reclameburo	reclamebureau
reclame's	reclames
reclameuitingen	reclame-uitingen
recruteerde	rekruteerde
recruteert	rekruteert
recruten	rekruten
reddingwerk	reddingswerk
reflexie	reflectie
reflexies	reflecties
regina	Regina
regio`s	regio's
reincarnatie	reïncarnatie
reincarnaties	reïncarnaties
reincarneren	reïncarneren
reïntegratiebedrijf	re-integratiebedrijf
reïntegratiebedrijven	re-integratiebedrijven
reïntegratiebudget	re-integratiebudget
reïntegratiebudgetten	re-integratiebudgetten
reïntegratiekandidaten	re-integratiekandidaten
reïntegratiekansen	re-integratiekansen
reïntegratiekans	re-integratiekans
reïntegratiekosten	re-integratiekosten
reïntegratiemaatregelen	re-integratiemaatregelen
reïntegratiemaatregel	re-integratiemaatregel
reïntegratiemarkt	re-integratiemarkt
reïntegratiemethoden	re-integratiemethoden
reïntegratiemiddelen	re-integratiemiddelen
reïntegratiemogelijkheden	re-integratiemogelijkheden
reïntegratiemonitor	re-integratiemonitor
reïntegratieondersteuning	re-integratieondersteuning
reïntegratieopdrachten	re-integratieopdrachten
reïntegratieovereenkomsten	re-integratieovereenkomsten
reïntegratieovereenkomst	re-integratieovereenkomst
reïntegratiepakket	re-integratiepakket
reïntegratieplannen	re-integratieplannen
reïntegratieplan	re-integratieplan
reïntegratieplicht	re-integratieplicht
reïntegratiepogingen	re-integratiepogingen
reïntegratiepraktijk	re-integratiepraktijk
reïntegratiepremie	re-integratiepremie
reïntegratieproblematiek	re-integratieproblematiek
reïntegratieproces	re-integratieproces
reïntegratieprocessen	re-integratieprocessen
reïntegratieproducten	re-integratieproducten
reïntegratieprogramma	re-integratieprogramma
reïntegratieprojecten	re-integratieprojecten
reïntegratieproject	re-integratieproject
reïntegratieregelingen	re-integratieregelingen
reïntegratie	re-integratie
reïntegratieresultaten	re-integratieresultaten
reïntegratiesector	re-integratiesector
reïntegratiesubsidies	re-integratiesubsidies
reïntegratietaak	re-integratietaak
reïntegratietaken	re-integratietaken
reïntegratietelefoon	re-integratietelefoon
reïntegratietoeslag	re-integratietoeslag
reïntegratietrajecten	re-integratietrajecten
reïntegratietraject	re-integratietraject
reïntegratie-uitkeringen	re-integratie-uitkeringen
reïntegratie-uitkering	re-integratie-uitkering
reïntegratieverantwoordelijkheid	re-integratieverantwoordelijkheid
reïntegratieverplichtingen	re-integratieverplichtingen
reïntegratieverplichting	re-integratieverplichting
reïntegratieverslagen	re-integratieverslagen
reïntegratieverslag	re-integratieverslag
reïntegratievisie	re-integratievisie
reïntegratievoorzieningen	re-integratievoorzieningen
reïntegratievoorziening	re-integratievoorziening
reïntegratievraag	re-integratievraag
reïntegratiewerkzaamheden	re-integratiewerkzaamheden
reïntegreerbaarheid	re-integreerbaarheid
reïntegreerbaar	re-integreerbaar
reïntegrerende	re-integrerende
reïntegrerend	re-integrerend
reïntegreren	re-integreren
reisbureau's	reisbureaus
reisburo	reisbureau
reisburo's	reisbureaus
reisplanner-app	reisplannerapp
rekreatie	recreatie
Relatiecadeau's	Relatiecadeaus
relationships	relaties
Rembrand	Rembrandt
remixing	remixen
renaisanceschilders	renaissanceschilders
René's	Renés
rens	Rens
rentegratie	re-integratie
retrainen	hertrainen
retrain	hertrain
retraining	hertraining
reuzachtige	reusachtige
reuzachtig	reusachtig
reve	Reve
revisieïnformatie	revisie-informatie
rhetorische	retorische
rhinoplastiek	rinoplastiek
rhododendron	rododendron
rhododendrons	rododendrons
Riccò	Ricco
rIchtlijn	richtlijn
rij-examen	rijexamen
rij-examens	rijexamens
rij-instructeur	rijinstructeur
rij-instructeurs	rijinstructeurs
rijkende	reikende
rijkend	reikend
rijksvoorlichtingsdienst	Rijksvoorlichtingsdienst
rijkswaterstaat	Rijkswaterstaat
rijnwater	Rijnwater
Rijssel	Rijsel
rijswijk	Rijswijk
risico-arm	risicoarm
risico-niveau's	risiconiveaus
risico`s	risico's
roestvrijstaal	roestvrij staal
rogge-aren	roggearen
romeins	Romeins
rondgebreidt	rondgebreid
rondgeleidt	rondgeleid
rontonden	rotonden
rontonde	rotonde
rontondes	rotondes
rontondetje	rotondetje
rontondetjes	rotondetjes
roodbeen	Roodbeen
roodbol	Roodbol
roodlicht	roodlicht-
roodwitte	rood-witte
rosé's	rosés
rozelgel	rozengelei
rsi-klachten	RSI-klachten
rsi	RSI
rug-belettering	rugbelettering
ruggegraad	ruggengraat
ruggegraat	ruggengraat
ruggengraad	ruggengraat
RuG	RUG
rugske	rugje
ruimbemeten	ruim bemeten
ruimstestation	ruimtestation
ruimtevaarttuigen	ruimtevaartuigen
ruitercorps	ruiterkorps
ruiterskorps	ruiterkorps
rummikub	Rummikub
ruzie-achtige	ruzieachtige
Saint Laurent du Maroni	Saint-Laurent-du-Maroni
salaam aleikum	salam aleikum
Salaì	Salaino
salem	Salem
samengesteldt	samengesteld
samengestelt	samengesteld
samengevoegt	samengevoegd
samenwerkingverband	samenwerkingsverband
samuraiklasse	samoeraiklasse
samurai	samoerai
samuraizwaard	samoeraizwaard
's anderedaags	's anderendaags
sangen	Sangen
sappie	sapje
sat	dat
s`avonds	's avonds
s-bocht	S-bocht
Scandinavian	Scandinavisch
Scandinavia	Scandinavië
Scandinaviers	Scandinaviërs
Scandinavie	Scandinavië
schaalniveau's	schaalniveaus
Schaerbeek	Schaarbeek
scheepverkeer	scheepsverkeer
scheidrechter	scheidsrechter
schen	schenk
schie	Schie
schilderswijk	Schilderswijk
schilpad	schildpad
schilp	Schilp
Schiphol/Rijk	Schiphol-Rijk
schoollokaties	schoollocaties
schoonheidspecialiste	schoonheidsspecialiste
Schottkytunnelbarri`ere	Schottkytunnelbarrière
schraven	Schraven
schreur	Schreur
schriftplaats	Schriftplaats
schrijfmachien	schrijfmachine
schrijvert	schrijver
schutterscorps	schutterskorps
sd	SD
seaports	zeehavens
seaport	zeehaven
secretaressendag	secretaressedag
secretaressenoverleg	secretaresseoverleg
sekreten	secreten
sekte-achtige	sekteachtige
selectiebureau's	selectiebureaus
semi-actief	semiactief
semi-akoestische	semiakoestische
semi-akoestisch	semiakoestisch
semi-ambtelijke	semiambtelijk
semi-ambtelijk	semiambtelijk
semi-aquatische	semiaquatische
semi-autobiografische	semiautobiografische
semi-autobiografisch	semiautobiografisch
semi-automatische	semiautomatische
semi-automatisch	semiautomatisch
semi-autonome	semiautonome
semi-autonoom	semiautonoom
semi-chronische	semichronische
semi-collectieve	semicollectieve
semi-commerciële	semicommerciële
semi-dichte	semidichte
semi-dwingend	semidwingend
semi-empirische	semiempirische
semi-feodale	semifeodale
semi-gesloten	semigesloten
semi-gestructureerde	semigestructureerde
semi-gestructureerd	semigestructureerd
semi-grafische	semigrafische
semi-klassieke	semiklassieke
semi-kwantitatief	semikwantitatief
semi-legale	semilegale
semi-logistieke	semilogistieke
semi-militaire	semimilitaire
semi-natuurlijke	seminatuurlijke
semi-onafhankelijke	semionafhankelijke
semi-openbaar	semiopenbaar
semi-openbare	semiopenbare
semi-permanente	semipermanente
semi-professionele	semiprofessionele
semi-transparante	semitransparante
semi-verharde	semiverharde
sempel	stempel
septer	scepter
sergant-majoor	sergeant-majoor
sérieux'	sérieux
service-georiënteerde	servicegeoriënteerde
service-georiënteerd	servicegeoriënteerd
serviers	Serviërs
servie	Servië
servietten	serviettes
sexleven	seksleven
sex	seks
's Gravenbrakel	's-Gravenbrakel
's Gravenvoeren	's-Gravenvoeren
's Gravenwezel	's-Gravenwezel
’sHertogenbosch	's-Hertogenbosch
s-Hertogenbosch	's-Hertogenbosch
ships	tallships
ship	tallship
siene	sirene
silvester	Silvester
sin	in
sint-bernardhonden	sint-bernardshonden
sint-bernardhondje	sint-bernardshondje
sint-bernardhondjes	sint-bernardshondjes
sint-bernardhond	sint-bernardshond
sint-bernhardhonden	sint-bernardshonden
sint-bernhardhondje	sint-bernardshondje
sint-bernhardhondjes	sint-bernardshondje
sint-bernhardhond	sint-bernardshond
sjieke	chique
sjieker	chiquer
skiërt	skiër
ski-jacke	ski-jack
skijackje	ski-jackje
skijackjes	ski-jackjes
skijack	ski-jack
skijacks	ski-jacks
skijasje	ski-jasje
skijasjes	ski-jasjes
skijassen	ski-jassen
skijas	ski-jas
slachttanden	slagtanden
slachttand	slagtand
slechtse	slechtste
sleeds	sleets
slijmvlieirritatie	slijmvliesirritatie
slotevent	slotevenement
smartwatche	smartwatches
s`middags	's middags
s`morgens	's morgens
's morgensvroeg	's morgens vroeg
sms-en	sms'en
sms-ten	sms'ten
sms-te	sms'te
smtp-account	SMTP-account
s`nachts	's nachts
Snappie	Snap je
sneak-peak	sneakpeek
sneakpeak	sneakpeek
sneak peek	sneakpeek
sneak preview	sneakpreview
sneak-preview	sneakpreview
snitzel	schnitzel
snoeverd	snoever
sociaalethische	sociaal-ethische
sociaalethisch	sociaal-ethisch
sociaalmedische	sociaal-medisch
sociaalmedisch	sociaal-medisch
sociaal-realisme	sociaalrealisme
sociaalrealistisch	sociaal-realistisch
soeppie	soepje
soeten	Soeten
softwar	software
soppie	sopje
soufleur	souffleur
soul-achtige	soulachtige
Soundcloud	SoundCloud
souveniertjes	souvenirtjes
sovjetmacht	Sovjetmacht
sovjetperiode	Sovjetperiode
sovjetregime	Sovjetregime
sovjetstaat	Sovjetstaat
spagettie	spaghetti
spagetti	spaghetti
spand	spant
specialismes	specialismen
speci	specie
spellingswijziging	spellingwijziging
sperciebonen	sperziebonen
spercieboon	sperzieboon
spercieboontje	sperzieboontje
spercieboontjes	sperzieboontjes
sp'er	SP'er
sp-er	SP'er
Sp-er	SP'er
SP-er	SP'er
sp'ers	SP'ers
sp-ers	SP'ers
Sp-ers	SP'ers
SP-ers	SP'ers
SP-Fractie	SP-fractie
spierpeesovergang	spier-peesovergang
spinnenrag	spinrag
SP-kamerleden	SP-Kamerleden
SP-kamerlid	SP-Kamerlid
sponseren	sponsoren
sponser	sponsor
sponsers	sponsors
sponsert	sponsort
sponsorship	sponsorschap
Sponsorship	Sponsorschap
sponsorships	sponsorschap
sportaccomodatie	sportaccommodatie
sportaccomodaties	sportaccommodaties
sportbh	sport-bh
sportbh's	sport-bh's
stacato	staccato
stage-achtige	stageachtige
stagiares	stagiaires
stagiare	stagiaire
stagieres	stagiaires
stagières	stagiaires
stagière	stagiaire
stampot	stamppot
starterd	starter
startlokatie	startlocatie
statenvergadering	Statenvergadering
state-of-the-art	state of the art
statiebezoek	staatsiebezoek
statiefoto	staatsiefoto
statieportret	staatsieportret
status-quo	status quo
stedebouwkunde	stedenbouwkunde
stedebouwkundigen	stedenbouwkundigen
stedebouwkundige	stedenbouwkundige
stedebouwkundig	stedenbouwkundig
steenbokskeerkring	Steenbokskeerkring
steengrillert	steengrill
steenwijk	Steenwijk
stelstel	stelsel
stembureau's	stembureaus
stemburo	stembureau
stemmerd	stemmer
stereotiepen	stereotypen
ster-reclame's	STER-reclames
Ster-reclame's	STER-reclames
STER-reclame's	STER-reclames
stet	stelt
stevend	stevent
stijle	steile
stilgelegt	stilgelegd
stillaan	stilaan
stiltecoupe	stiltecoupé
stokskes	stokjes
stortlokaties	stortlocaties
stortlokatie	stortlocatie
Straat van Otranto	Kanaal van Otranto
strafrechterlijke	strafrechtelijke
strafrechterlijk	strafrechtelijk
strakkies	straks
studentenkorpsen	studentencorpsen
studentenkorps	studentencorps
studieuitval	studie-uitval
studio`s	studio's
stukkende	stukgaande
stukkend	stukgaand
stukskes	stukjes
subkommissie	subcommissie
subsidieuitgaven	subsidie-uitgaven
subway	Subway
succe`s	succés
super-deluxe	super-de-luxe
superde-luxe	super-de-luxe
superdeluxe	super-de-luxe
surseillance	surseance
symphatisanten	sympathisanten
synths	synthesizers
synth	synthesizer
taand	taant
tableau's	tableaus
talkies	walkietalkies
talmudisten	Talmoedisten
talmud	Talmoed
Talmud	Talmoed
taluuds	taluds
tamboercorps	tamboerkorps
tamboermaître	tambour-maître
tankcorps	tankkorps
tarwe-aren	tarwearen
tau-eiwit	taueiwit
tau-eiwitten	taueiwitten
taxie	taxi
taxi`s	taxi's
technieker	technicus
tegend	tegen
tègen	tégen
tekeningskes	tekeningetjes
tekomen	te komen
telastelegging	tenlastelegging
telefonen	telefoons
telefoonsgegevens	telefoongegevens
teleurgesteldt	teleurgesteld
teleurgestelt	teleurgesteld
televisiequizen	televisiequizzen
televisieuitzendingen	televisie-uitzendingen
televisieuitzending	televisie-uitzending
teminste	tenminste
t.e.m	t/m
teneergeslagen	terneergeslagen
teneer	terneer
tengevolge	ten gevolge
teniet gedaan	tenietgedaan
tentoongespreidt	tentoongespreid
tentoongestelt	tentoongesteld
tentoonstelingen	tentoonstellingen
ten tweede male	ten tweeden male
tenwiji	terwijl
terechtwijzigingen	terechtwijzingen
ter elfder ure	te elfder ure
tergelijkertijd	tegelijkertijd
ternouwernood	ternauwernood
terpetijn	terpentijn
teruggebelt	teruggebeld
teruggedraait	teruggedraaid
teruggekeert	teruggekeerd
teruggemeldt	teruggemeld
teruggeschroeft	teruggeschroefd
teruggestord	teruggestort
teruggestuurt	teruggestuurd
teruggeweest	terug geweest
terwiji	terwijl
te`	té
tevrede	tevreden
teweten	te weten
tezetten	te zetten
tezijnertijd	te zijner tijd
thema`s	thema's
therapieituatie	therapiesituatie
threesome	trio
THT-datum	t.h.t.-datum
thuisvoelden	thuis voelden
thuisvoelde	thuis voelde
thuisvoel	thuis voel
thuisvoelt	thuis voelt
thuya's	thuja's
tie-wraps	tiewraps
tie-wrap	tiewrap
tig-lassen	TIG-lassen
tiglassen	TIG-lassen
tijl	teil
timon	Timon
TIO	Tio
tissen	tussen
tis	't is
TL-armaturen	tl-armaturen
TL-armatuur	tl-armatuur
TL-balk	tl-balk
TL-buis	tl-buis
TL-buizen	tl-buizen
TL-lampen	tl-lampen
TL-lamp	tl-lamp
TL-licht	tl-licht
TL-verlichting	tl-verlichting
tòch	tóch
tocques	toques
tocque	toque
toegangkelijk	toegankelijk
toegedient	toegediend
toegejuichd	toegejuicht
toegejuigd	toegejuicht
toegekendt	toegekend
toegekent	toegekend
toegelegt	toegelegd
toegepasd	toegepast
toegestaand	toegestaan
toegestuurdt	toegestuurd
toegestuurt	toegestuurd
toegevoegdt	toegevoegd
toegevoegt	toegevoegd
toegewensd	toegewenst
toegewijdt	toegewijd
toegezegt	toegezegd
toejuigen	toejuichen
toendertijd	toentertijd
toeroperators	touroperators
toeroperator	touroperator
toevalig	toevallig
Tokyo	Tokio
top-100	top 100
top-10	top 10
top-12	top 12
top-15	top 15
top-16	top 16
top-200	top 200
top-20	top 20
top-24	top 24
top-25	top 25
top-2	top 2
top-30	top 30
top-3	top 3
top-40	top 40
top-4	top 4
top-500	top 500
top-50	top 50
top-5	top 5
top-6	top 6
top-8	top 8
toplokaties	toplocaties
toplokatie	toplocatie
topvijf	top vijf
torend	torent
tòt	tót
toy boys	toyboys
toy boy	toyboy
toyota	Toyota
trace's	tracés
tracé's	tracés
tractaat	traktaat
tragediënnes	tragédiennes
transactieuitgaven	transactie-uitgaven
Transactieuitgaven	Transactie-uitgaven
Trans-Kaukasië	Transkaukasië
traumahelicopter	traumahelikopter
treener	trainer
trener	trainer
tre	te
tricht	Tricht
trillingsniveau's	trillingsniveaus
trollende	pestende
truuken	truken
truukjes	trucjes
truukje	trucje
truuks	trucs
truuk	truc
t-shirten	T-shirts
t-shirtjes	T-shirtjes
t-shirtje	T-shirtje
tshirtje	T-shirtje
t-shirts	T-shirts
tshirts	T-shirts
t-shirt	T-shirt
tshirt	T-shirt
Tshirt	T-shirt
Tsjchinvali	Tsinvali
Tunesier	Tunesiër
Tunesie	Tunesië
turkije	Turkije
tussend	tussen
Tuva	Toeva
tv-programma`s	tv-programma's
twee-aderige	tweeaderige
twee-aderig	tweeaderig
twee-armige	tweearmige
twee-armig	tweearmig
twee-assige	tweeassige
twee-assig	tweeassig
tweecylinder	tweecilinder
Tweedekamerleden	Tweede Kamerleden
Tweede Kamer-leden	Tweede Kamerleden
Tweede-Kamer-leden	Tweede Kamerleden
Tweedekamer	Tweede Kamer
tweede-kansonderwijs	tweedekansonderwijs
tweeëneenhalf	tweeënhalf
tweeliter	tweeliter-
tweeverblijvers	tweedeverblijvers
tweeverblijver	tweedeverblijver
tweevijfde	twee vijfde
twitter	Twitter
type's	types
uberhaubt	überhaupt
uberhaupt	überhaupt
uitbesteet	uitbesteed
uitbreidingslokaties	uitbreidingslocaties
uitelkaar	uit elkaar
uitgangpunt	uitgangspunt
uitgebaad	uitgebaat
uitgebalanceert	uitgebalanceerd
uitgebeeldt	uitgebeeld
uitgebloeit	uitgebloeid
uitgebouwt	uitgebouwd
uitgebrandt	uitgebrand
uitgebreidt	uitgebreid
uitgebreit	uitgebreid
uitgebroedt	uitgebroed
uitgebuidt	uitgebuit
uitgebuid	uitgebuit
uitgedaagt	uitgedaagd
uitgedeelt	uitgedeeld
uitgedijdt	uitgedijd
uitgedoktert	uitgedokterd
uitgedooft	uitgedoofd
uitgedraait	uitgedraaid
uitgedroogt	uitgedroogd
uitgeduidt	uitgeduid
uitgedunt	uitgedund
uitgefreesdt	uitgefreesd
uitgegooit	uitgegooid
uitgegroeidt	uitgegroeid
uitgegroeit	uitgegroeid
uitgehaaldt	uitgehaald
uitgehaalt	uitgehaald
uitgehardt	uitgehard
uitgeholt	uitgehold
uitgehuwelijkd	uitgehuwelijkt
uitgekamt	uitgekamd
uitgekeert	uitgekeerd
uitgekient	uitgekiend
uitgekleedt	uitgekleed
uitgeleeft	uitgeleefd
uitgeleent	uitgeleend
uitgelegdt	uitgelegd
uitgelegt	uitgelegd
uitgelevert	uitgeleverd
uitgelijndt	uitgelijnd
uitgelijnt	uitgelijnd
uitgelood	uitgeloot
uitgelooft	uitgeloofd
uitgemondt	uitgemond
uitgemoordt	uitgemoord
uitgenodigt	uitgenodigd
uitgeoefent	uitgeoefend
uitgepland	uitgeplant
uitgeplunderdt	uitgeplunderd
uitgeprobeert	uitgeprobeerd
uitgerede	uitgereden
uitgereikd	uitgereikt
uitgerekent	uitgerekend
uitgeroeidt	uitgeroeid
uitgeroeit	uitgeroeid
uitgerokken	uitgetrokken
uitgerolt	uitgerold
uitgeschakelt	uitgeschakeld
uitgesmeert	uitgesmeerd
uitgespaart	uitgespaard
uitgespeeldt	uitgespeeld
uitgespeelt	uitgespeeld
uitgespreidt	uitgespreid
uitgestaldt	uitgestald
uitgestalt	uitgestald
uitgestelt	uitgesteld
uitgestippelt	uitgestippeld
uitgestrooit	uitgestrooid
uitgestuurt	uitgestuurd
uitgetelt	uitgeteld
uitgevaardigt	uitgevaardigd
uitgevoerdt	uitgevoerd
uitgevoert	uitgevoerd
uitgeweidt	uitgeweid
uitgewisselt	uitgewisseld
uitgewoedt	uitgewoed
uitgezonderdt	uitgezonderd
uitgezondert	uitgezonderd
uitgezwaait	uitgezwaaid
uitkan	uit kan
uitkon	uit kon
uitkunt	uit kunt
uitleglokaties	uitleglocaties
uitstekkende	uitstekende
uitstekkend	uitstekend
uitstromert	uitstromer
uitwijden	uitweiden
uitzendbureau's	uitzendbureaus
uitzendburo's	uitzendbureaus
uitzendburo	uitzendbureau
uizetten	uitzetten
ukkies	ukjes
ulcussen	ulcera
UML-klassediagrammen	UML-klassendiagrammen
UML-klassediagram	UML-klassendiagram
url's	URL's
urls	URL's
URLs	URL's
url	URL
usb-aansluiting	USB-aansluiting
usb-kabel	USB-kabel
usb-poorten	USB-poorten
usb-poort	USB-poort
usb-stickje	USB-stickje
usb-sticks	USB-sticks
usb-stick	USB-stick
USBstick	USB-stick
usb	USB
utrecht	Utrecht
ù	ú
uuuuuuren	úren
u-vormig	U-vormig
ùw	úw
vacature's	vacatures
vacuüm verpakt	vacuümverpakt
vaders kant	vaderskant
vakantielokatie	vakantielocatie
vakantieuitkering	vakantie-uitkering
valent	Valent
vam	van
vanacht	vannacht
Vanales	Van alles
vanalles	van alles
vandeze	van deze
vandien	van dien
vanile	vanille
vanilje	vanille
vanilla	vanille
vanilleijs	vanille-ijs
vanweg	vanwege
van zinnens zijn	zinnens zijn
variantie-analyses	variantieanalyses
variantie-analyse	variantieanalyse
vastenland	vasteland
vastgeklemt	vastgeklemd
vastgelegt	vastgelegd
vastgelijmdt	vastgelijmd
vastgeschroeft	vastgeschroefd
vastgesteldt	vastgesteld
vastgestelt	vastgesteld
vd	v.d.
vechtschijding	vechtscheiding
veda's	Veda's
veda	Veda
vedische	Vedische
veeeeeeel	véél
veeeeeel	véél
véééééél	véél
vééééél	véél
véééél	véél
vééél	véél
veelbetekende	veelbetekenende
veelbetekend	veelbetekenend
veeltoegepaste	veel toegepaste
veiligheidlekken	veiligheidslekken
veiligheidregio's	veiligheidsregio's
veiligheidscorps	veiligheidskorps
veken	velen
veldhuis	Veldhuis
ventillatie	ventilatie
verantwoordbaar	verantwoordelijk
verantwoordbare	verantwoordelijke
verantwoordelekheit	verantwoordelijkheid
verantwoordelij	verantwoordelijk
verantwoort	verantwoord
Verbauwen	Verbouwen
verbeelt	verbeeld
verbiddert	verbittert
verbindingstukjes	verbindingsstukjes
verblijfsaccomodatie	verblijfsaccommodatie
verblijt	verblijd
verbrant	verbrand
verdampd	verdampt
verderweg	verder weg
verdiepd	verdiept
vereisd	vereist
vergoet	vergoed
vergult	verguld
verhart	verhard
verjaardagskadootje	verjaardagscadeautje
verjaardagskado	verjaardagscadeau
verkiezings	verkiezing
verkleet	verkleed
verkloodt	verkloot
verledt	verlet
verled	verlet
verleedt	verleed
verlosd	verlost
verluit	verluid
vermelt	vermeld
vermisd	vermist
vermoet	vermoed
vermoort	vermoord
veronderstelen	veronderstellen
veroorzaakd	veroorzaakt
verplaatsd	verplaatst
verranderingen	veranderingen
verrasd	verrast
verschafd	verschaft
verschansd	verschanst
ver-schillen	verschillen
verschuren	verscheuren
vershuiste	verhuisde
version	versie
versnellingskes	versnellinkjes
verspreit	verspreid
verstandkies	verstandskies
versterkd	versterkt
versufd	versuft
vertolkd	vertolkt
vertouwen	vertrouwen
vervalsd	vervalst
verversd	ververst
vervreemt	vervreemd
verwachd	verwacht
verwachtigingen	verwachtingen
verwerkd	verwerkt
verwijzigingen	verwijzingen
verwoesd	verwoest
verwoort	verwoord
verzed	verzet
verzende	verzenden
verzonde	verzonden
verzorgingstaat	verzorgingsstaat
vetellen	vertellen
veul	veel
v-hals	V-hals
vice-admiraal	viceadmiraal
vice-burgemeester	viceburgemeester
vice-decaan	vicedecaan
vice-directeur	vicedirecteur
vice-fractievoorzitter	vicefractievoorzitter
vice-gouverneur	vicegouverneur
vice-kanselier	vicekanselier
vice-ministers	viceministers
vice-premierschap	vicepremierschap
vice-premiers	vicepremiers
vice-premier	vicepremier
vice-Premier	vicepremier
vice-presidenten	vicepresidenten
vice-presidentschap	vicepresidentschap
vice-presidentskandidaat	vicepresidentskandidaat
vice-presidentskandidaten	vicepresidentskandidaten
vice-presidentskandidate	vicepresidentskandidate
vice-presidentsschap	vicepresidentsschap
vice-president	vicepresident
vice-président	vicepresident
vice-rectoren	vicerectoren
vice-rector	vicerector
vice-versa	vice versa
vice-voorzitster	vicevoorzitster
vice-voorzitterschap	vicevoorzitterschap
vice-voorzitters	vicevoorzitters
vice-voorzitter	vicevoorzitter
vic	VIC
video`s	video's
viercylinder	viercilinder
vier-en-een-half	vier en een half
vierliter	vierlitermotor
vierschansentoernooi	Vierschansentoernooi
vij	bij
vijfen	vijven
vijfsterren	vijf sterren
vinex-locaties	Vinex-locaties
vinexlocaties	Vinex-locaties
Vinexlocaties	Vinex-locaties
vinex-locatie	Vinex-locatie
Vinexlocatie	Vinex-locatie
Vinex-lokaties	Vinex-locaties
VINEX-lokaties	Vinex-locaties
Vinex-lokatie	Vinex-locatie
VINEX-lokatie	Vinex-locatie
vinex	Vinex
vinex-wijken	Vinex-wijken
vinexwijken	Vinex-wijken
Vinexwijken	Vinex-wijken
vinexwijk	Vinex-wijk
Vinexwijk	Vinex-wijk
viruses	virussen
vis-a`-vis	vis-à-vis
viscose-oplossingen	viscoseoplossingen
viscose-oplossing	viscoseoplossing
viskes	visjes
visserschip	vissersschip
vitamine c	vitamine C
vliegerscorps	vliegerskorps
vliegezwam	vliegenzwam
vmbo-ers	vmbo'ers
voedingsupplementen	voedingssupplementen
voices	stemmen
Voigtstraatstraat	Voigtstraat
volkenbond	Volkenbond
volkerenbond	Volkerenbond
volklied	volkslied
volkslatijn	Volkslatijn
volkstam	volksstam
voltijdsaanstellingen	voltijdaanstellingen
voltijdsaanstelling	voltijdaanstelling
voltijdsfuncties	voltijdfuncties
voltijdsfunctie	voltijdfunctie
volzit	vol zit
vooraal	vooral
voorals	vooralsnog
voorbijgestreeft	voorbijgestreefd
vooreen	voor een
voorelkaar	voor elkaar
voorgelegt	voorgelegd
voorgeschotelt	voorgeschoteld
voorgesteldt	voorgesteld
voorgestelt	voorgesteld
voorgewendt	voorgewend
voork	voor
voormij	voor mij
voor-stellen	voorstellen
voortuitgang	vooruitgang
vooruitstuwen	voortstuwen
vòòr	vóór
Vòòr	Vóór
voorzicht	voorzichtig
voorzittersschap	voorzitterschap
voorzittert	voorzitter
voorzorgsmaatregelingen	voorzorgsmaatregelen
voorzover	voor zover
voostel	voorstel
vossebes	vossenbes
votes	stemmen
vredescorps	vredeskorps
vriende	vrienden
vrijcorps	vrijkorps
vrijescholen	vrije scholen
vrijeschool	vrije school
vrijetijd	vrije tijd
vrijheidsstelling	invrijheidstelling
vrijheidstelling	invrijheidstelling
vrijiating	vrijlating
vrijwilligerscorps	vrijwilligerskorps
vrolijkhijd	vrolijkheid
vrouwlijke	vrouwelijke
vrouwzijn	vrouw-zijn
vryheid	vrijheid
V.S.	VS
vulcanoloog	vulkanoloog
vvd'ers	VVD'ers
vvd-ers	VVD'ers
vvders	VVD'ers
VVD-ers	VVD'ers
vvd'er	VVD'er
vvd-er	VVD'er
vvder	VVD'er
VVD-er	VVD'er
vvd	VVD
waadoor	waardoor
waalwijk	Waalwijk
waand	waant
waarbijde	waarbij de
waardenlijsten	waardelijsten
waardenlijst	waardelijst
waarempel	warempel
waaròm	waaróm
waarrempel	warempel
waarschijlijk	waarschijnlijk
Waddezee	Waddenzee
walkie-talkies	walkietalkies
wallonnes	Waals
wankelmoter	wankelmotor
-wanneer	wanneer
-want	want
WAO-ers	WAO'ers
wardoor	waardoor
warmtekrachtcentrale	warmte-krachtcentrale
warmtekrachtinstallatie	warmte-krachtinstallatie
warmtekrachtkoppeling	warmte-krachtkoppeling
-was	was
watercypres	watercipres
watvraag	wat-vraag
watvragen	wat-vragen
-wat	wat
weaknesses	zwakheden
-wederom	wederom
wedstijd	wedstrijd
weekskes	weekjes
-wegens	wegens
weggebrandt	weggebrand
weggeëbt	weggeëbd
weggegooit	weggegooid
weggehaalt	weggehaald
-weggejorist-	weggejorist
weggelegt	weggelegd
weggeleidt	weggeleid
weggespoelt	weggespoeld
weggestuurt	weggestuurd
weggevaagt	weggevaagd
weggevoert	weggevoerd
wekflesjes	weckflesjes
wekflesje	weckflesje
wekflessen	weckflessen
wekfles	weckfles
wekking	werking
weldegelijk	wel degelijk
welicht	wellicht
-weliswaar	weliswaar
-welke	welke
welles-nietes-spelletje	welles-nietesspelletje
welles-nietes-spel	welles-nietesspel
-wellicht	wellicht
welteruste	welterusten
weltrusten	welterusten
weltruste	welterusten
-wel	wel
we`l	wél
We`l	Wél
wèl	wél
wepsen	wespen
wepsjes	wespjes
wepsje	wespje
weps	wesp
wereldhandelsorganisatie	Wereldhandelsorganisatie
wereldschaakbond	Wereldschaakbond
-wereld	wereld
wèrkelijk	wérkelijk
werkingsfeer	werkingssfeer
werklokaties	werklocaties
Westelijke Duina	Westelijke Dvina
westende	Westende
westend	West End
westerscheldetunnel	Westerscheldetunnel
-westerse	westerse
Westeuropese	West-Europese
westfriese	West-Friese
Westfriese	West-Friese
westfriesland	West-Friesland
Westfriesland	West-Friesland
Westfries	West-Fries
-west	west
West-Zeeuws-Vlaanderen	West Zeeuws-Vlaanderen
wes	wens
wetenscha	wetenschap
wetswijzingen	wetswijzigingen
-we	we
whatsApp	WhatsApp
wienerschnitsels	wienerschnitzels
wienerschnitsel	wienerschnitzel
wiener schnitzels	wienerschnitzels
Wiener schnitzels	wienerschnitzels
wiener schnitzel	wienerschnitzel
Wiener schnitzel	wienerschnitzel
wienersnitsels	wienerschnitzels
wienersnitsel	wienerschnitzel
-wie	wie
wíe	wíé
wiite	witte
wijdser	weidser
wijdsheid	wijsheid
wijte	weet
-wij	wij
wij-zijgevoel	wij-zij-gevoel
wildeweg	wilde weg
wilde Westen	Wilde Westen
wìllen	wíllen
wìl	wíl
Wim2	Wim
winaars	winnaars
winlokatie	winlocatie
winning mood	winningmood
Wob-ambtenaren	WOB-ambtenaren
Wob-informatie	WOB-informatie
Wob-procedure	WOB-procedure
Wob-verzoeken	WOB-verzoeken
Wob-verzoek	WOB-verzoek
WOII-heden	WO II-helden
WOIII	WO III
WOII	WO II
WOI	WO I
wolkenloze	wolkeloze
woningbouwlokaties	woningbouwlocaties
woonlokatie	woonlocatie
woonzorgzones	woon-zorgzones
woordvoeder	woordvoerder
woordvoerdster	woordvoerster
Wordfued	Wordfeud
-wordt	wordt
would-be-actrice	would-beactrice
x-benen	X-benen
xenos	Xenos
XTC-aanpak	xtc-aanpak
XTC-achtige	xtc-achtige
XTC-achtig	xtc-achtig
XTC-beleid	xtc-beleid
XTC-gebruik	xtc-gebruik
XTC-groep	xtc-groep
XTC-handel	xtc-handel
XTC-koeriers	xtc-koeriers
XTC-laboratorium	xtc-laboratorium
XTC-lab	xtc-lab
XTC-markt	xtc-markt
XTC-misdrijf	xtc-misdrijf
XTC-misdrijven	xtc-misdrijven
XTC-onderzoek	xtc-onderzoek
XTC-pillen	xtc-pillen
XTC-pil	xtc-pil
XTC-productie	xtc-productie
XTC-smokkel	xtc-smokkel
XTC-tabletten	xtc-tabletten
XTC-transporten	xtc-transporten
XTC-zaak	xtc-zaak
XTC-zaken	xtc-zaken
yakboter	jakboter
yakboterthee	jakboterthee
yak	jak
yakmest	jakmest
yaks	jaks
ye	te
youtube	YouTube
yvonne	Yvonne
zaaaaaalig	zálig
zaaaaalig	zálig
zaakske	zaakje
zagert	zager
zakdoekje-leggen	zakdoekjeleggen
zakskes	zakjes
zakske	zakje
-zal	zal
ZDNET	ZDNet
zedendeliquenten	zedendelinquenten
zee-arm	zeearm
zeeeeeeer	zéér
zeeeeeer	zéér
zeeeeer	zéér
zééééér	zéér
zeeëenden	zee-eenden
zeeëend	zee-eend
zéééér	zéér
zeeëgels	zee-egels
zeeëgeltjes	zee-egeltjes
zeeëgeltje	zee-egeltje
zeeëgel	zee-egel
zééér	zéér
zeergeëerde	zeer geëerde
zeergeëerd	zeer geëerd
zeeschilpadden	zeeschildpadden
zeeschilpad	zeeschildpad
zegend	zegent
zègt	zégt
zèg	zég
zèker	zéker
zèlfs	zélfs
ze`lf	zélf
zèlf	zélf
zelgeknutseld	zelfgeknutseld
zenger	zanger
zenith	zenit
zescylinder	zescilinder
ziekskes	ziekjes
ziektenkostenregelingen	ziektekostenregelingen
ziekte's	ziektes
zieleroerselen	zielenroerselen
zijde-achtig	zijdeachtig
zij-ingang	zijingang
zij-instromers	zijinstromers
zij-instromer	zijinstromer
zij-instroom	zijinstroom
zij-invoer	zijinvoer
zittinghebbende	zitting hebbende
zi	z.i.
zloties	zloty's
zlotie	zloty
ZMOK	zmok
z`n	z'n
zodadelijk	zo dadelijk
zodan	zoals
zoekert	zoeker
zoemert	zoemer
zoenert	zoener
zoëven	zo-even
zogezegde	zogezegd
zogezegdt	zogezegd
zogezegt	zogezegd
zombie-achtige	zombieachtige
-zonder	zonder
zònder	zónder
zone's	zones
zoniet	zo niet
zo`n	zo'n
Zo`n	Zo'n
zoodoende	zodoende
zooöloog	zoöloog
zooooooo	zó
Zooooooo	Zó
zoooooo	zó
Zoooooo	Zó
zoooooveel	zóveel
zooooo	zó
zóóóó	zó
zooo	zó
zóóó	zó
zóóveel	zóveel
zorgdraagt	zorg draagt
zorgdraag	zorg draag
zorgdroegen	zorg droegen
zorgdroeg	zorg droeg
zorginformatieuitwisseling	zorginformatie-uitwisseling
zoudne	zouden
-zou	zou
-zoveel	zoveel
zòveel	zoveel
zòveel	zóveel
-zowel	zowel
zowieso	sowieso
zowiezo	sowieso
zò	zó
Zò	Zó
zuigert	zuiger
zuipert	zuiper
Zululand	Zoeloeland
Zulu	Zoeloe
zweefvliegert	zweefvlieger
zwelden	zwollen
zwelde	zwol
zwemmert	zwemmer
zwermpjess	zwermpjes
zwervert	zwerver
zwevert	zwever
zwiepert	zwieper
zzp-ers	zzp'ers
ZZP'ers	zzp'ers
ZZP-ers	zzp'ers
zzp-er	zzp'er
ZZP'er	zzp'er
ZZP-er	zzp'er
ZZP	zzp
